[
{
    "type": "mapgen",
    "method": "json",
    "om_terrain": [ "hhpp1" ],
    "object": {
      "fill_ter": "t_floor",
      "rows": [
			"   *            *       ",
            "   *      *      *      ",
            "                *       ",
            "     *                 N",
            "           *          *N",
            "    *          *       N",
            "                *      N",
            " *    *           *    N",
            "     NNNNNNNNNNNNNNNNNNN",
            "   * Nbb...oN?..N.BeeB.N",
            "     Nb.t!.oNNNGN......N",
            "     N............!....N",
            " *   NBBBB.N.........TcN",
            "     NNNNNGN...NTT.....N",
            "  *  Nf....N...Ncc...TcN",
            "     Nf.!..+...NTT.....N",
            "     Nq....~...Ncc...TcN",
            "     N~....~...N..!....N",
            "    *Nq.!..~...NTT......",
            "  *  N~~~~~o...Ncc...cTN",
            "*    NWWWWWNWOONWWWWWWWN",
            "    wwwwwwwwwwwwwwwwwwww",
            "    wwwwwwwwwwwwwwwwwww ",
            "      wwwwwwwwwwwwwww   "
			],
			"palettes": [ "zwei_palette" ],
			"items": {
			},
			"place_npcs": [
		],
			"terrain": {
		"N": "t_brick_wall",
		"W": "t_reinforced_glass",
		"O": "t_ballistic_door_glass_c",
		"G": "t_door_gray_c",
		".": "t_floor",
		" ": [ [ "t_grass", 15], [ "t_dirt",1], [ "t_grass_dead", 3] ],
		"w": "t_sidewalk",
		"*": [ ["t_tree", 10] , ["t_tree_apple", 8], ["t_tree_peach", 5], ["t_tree_cherry", 7] ],
				"!": "t_floor_olight"
			},
		"furniture": { 
		"n": "f_desk",
		"h": "f_chair_black",
		"H": "f_chair_white",
		"c": "f_chair",
		"S": "f_sofa",
		"T": "f_table",
		"t": "f_coffee_table",
		"B": "f_bookcase",
		"q": "f_sink",
		"o": "f_glass_cabinet",
		"F": "f_wardrobe",
		"_": "f_curtain",
		"|": "f_rack_coat",
		"b": "f_rack",
		"~": "f_counter",
		"(": "f_cupboard",
		"e": "f_entertainment_center",
		"+": "f_counter_gate_c",
		"A": "f_armchair",
		"7": "f_chair_plywood",
		"?": "f_toilet",
		" ": [ ["f_flower_tulip", 13], ["f_black_eyed_susan",5], [ "f_bluebell", 8], [ "f_null", 200] ],
		"j": "f_bench_park",
		"Z": "f_bathtub",
		"X": "f_oven",
		"f": "f_fridge",
		"K": "f_safe_l"
		
		}
	}
},
{
    "type": "mapgen",
    "method": "json",
    "om_terrain": [ "hhpp2" ],
    "object": {
      "fill_ter": "t_floor",
      "rows": [
			"      *                 ",
            "   *      *             ",
            "                        ",
            "NNNNNNNNNNNNNNNNN *     ",
            "((((X(((((qff((.N     * ",
            "(............../N      *",
            "(..!~~~~~~~!.../N       ",
            "(...............N *     ",
            "NNNNNNNNNGNNNNGNN       ",
            "cc..cc|TT....N.,N    *  ",
            "TT.!TT|..!...N.,N       ",
            "cc..cc|||..||N!,N       ",
            "cc..cc|cc..ccN..N  *    ",
            "TT..TT|TT..TTN..N       ",
            "cc..cc|cc..ccN..N       ",
            "cc..cc|cc..ccN..N   * * ",
            "TT.!TT|TT!.TTN..N       ",
            "cc..cc|cc..ccN!.N  *    ",
            "..........```N.&N       ",
            "cTccTccTc````N.&N    *  ",
            "NNNNNNNNNNNNNNGNN       ",
            "wwwwwwwwwwwwwww      *  ",
            "            *           ",
            "      *           *     "
			],
			"palettes": [ "zwei_palette" ],
			"items": {
			},
			"place_npcs": [
		],
			"terrain": {
		"N": "t_brick_wall",
		"W": "t_wall_glass",
		"O": "t_reinforced_glass_shutter_open",
		"G": "t_door_gray_c",
		".": "t_floor",
		"|": "t_bars",
		" ": [ [ "t_grass", 15], [ "t_dirt",1], [ "t_grass_dead", 3] ],
		"w": "t_sidewalk",
		"`": "t_carpet_red",
		"*": [ ["t_tree", 10] , ["t_tree_apple", 8], ["t_tree_peach", 5], ["t_tree_cherry", 7] ],
				"!": "t_floor_olight"
			},
		"furniture": { 
		"n": "f_desk",
		"h": "f_chair_black",
		"H": "f_chair_white",
		"c": "f_chair",
		"S": "f_sofa",
		"T": "f_table",
		"t": "f_coffee_table",
		"B": "f_bookcase",
		"q": "f_sink",
		"o": "f_glass_cabinet",
		"F": "f_wardrobe",
		"_": "f_curtain",
		"&": "f_rack_coat",
		"b": "f_rack",
		"~": "f_counter",
		"(": "f_cupboard",
		"+": "f_counter_gate_c",
		"A": "f_armchair",
		"7": "f_chair_plywood",
		"?": "f_toilet",
		",": "f_locker",
		"/": "f_heavy_duty_freezer",
		" ": [ ["f_flower_tulip", 13], ["f_black_eyed_susan",5], [ "f_bluebell", 8], [ "f_null", 200] ],
		"j": "f_bench_park",
		"Z": "f_bathtub",
		"X": "f_oven",
		"f": "f_fridge",
		"K": "f_safe_l"
		
		}
	}
},
{
    "type": "mapgen",
    "method": "json",
    "om_terrain": [ "hhpp1_roof" ],
    "object": {
      "fill_ter": "t_flat_roof",
      "rows": [
			"                        ",
            "                        ",
            "                        ",
            "                       .",
            "                       .",
            "                       .",
            "                       .",
            "                       .",
            "     ...................",
            "     ...................",
            "     ...................",
            "     ...................",
            "     ...................",
            "     ...................",
            "     ...................",
            "     ...................",
            "     ...................",
            "     ...................",
            "     ...................",
            "     ...................",
            "     ...................",
            "                        ",
            "                        ",
            "                        "
	  ],
	  "palettes": [ "roof_palette" ]
	}
},
{
    "type": "mapgen",
    "method": "json",
    "om_terrain": [ "hhpp2_roof" ],
    "object": {
      "fill_ter": "t_flat_roof",
      "rows": [
			"                        ",
            "                        ",
            "                        ",
            ".................       ",
            ".................       ",
            ".................       ",
            ".................       ",
            ".................       ",
            ".................       ",
            ".................       ",
            ".................       ",
            ".................       ",
            ".................       ",
            ".................       ",
            ".................       ",
            ".................       ",
            ".................       ",
            ".................       ",
            ".................       ",
            ".................       ",
            ".................       ",
            "                        ",
            "                        ",
            "                        "
	  ],
	  "palettes": [ "roof_palette" ]
	}
}
]