[
  {
    "type": "mapgen",
    
    "om_terrain": [ "w_station" ],
    "weight": 500,
    "object": {
      "fill_ter": "t_concrete",
      "rows": [
        "                        ",
        "                        ",
        "    WWWWWWWWWWWWWWWW    ",
        "    W..............W    ",
        "  WWW..............WWW  ",
        "  W...4..........4...W  ",
        "  W..................W  ",
        "  W..................W  ",
        "  W..................W  ",
        "  W..................W  ",
        "  W..................W  ",
        "  W...4..........4...W  ",
        "  W......w....t.b.b.bW  ",
        "  W.............b.b.bW  ",
        "  L....k........b.b.bL  ",
        "  L..................L  ",
        "  L.............b.b.bL  ",
        "  L...4.........b4b.bL  ",
        "  L.............b.b.bL  ",
        "  WLW..............WLW  ",
        "    L..............L    ",
        "    WLLLLLWDDWLLLLLW    ",
        "NNNNNNNNNNNNNNNNNNNNNNNN",
        "NNNNNNNNNNNNNNNNNNNNNNNN"
      ],
      "faction_owner": [  ],
      "place_npcs": [  ],
      "terrain": {
        "D": "t_door_metal_c",
        "N": "t_concrete",
        "L": "t_ballistic_glass",
        "W": "t_brick_wall",
        "4": "t_floor_olight",
        " ": [ [ "t_grass", 15 ], [ "t_dirt", 1 ], [ "t_grass_dead", 3 ] ]
      },
      "furniture": {  
        "w": "f_warp_terminal",
        "t": "f_train_platform",
        "b": "f_bench",
        "k": "f_internet_kiosk"
      }
    }
  },
  {
    "type": "mapgen",
    
    "om_terrain": [ "w_station_r" ],
    "weight": 500,
    "object": {
      "fill_ter": "t_concrete",
      "rows": [
        "                        ",
        "                        ",
        "    ................    ",
        "    ................    ",
        "  ....................  ",
        "  ....................  ",
        "  ....................  ",
        "  ....................  ",
        "  ....................  ",
        "  ....................  ",
        "  ....................  ",
        "  ....................  ",
        "  ....................  ",
        "  ....................  ",
        "  ....................  ",
        "  ....................  ",
        "  ....................  ",
        "  ....................  ",
        "  ....................  ",
        "  ....................  ",
        "    ................    ",
        "    ................    ",
        "                        ",
        "                        "
      ],
      "faction_owner": [  ],
      "place_npcs": [  ],
      "palettes": [ "roof_palette" ]
    }
  }
]
