[
  {
    "type": "mapgen",
    "method": "json",
    "om_terrain": [
      [ "w_station_lt", "w_station_mt2", "w_station_mt1", "w_station_rt" ],
      [ "w_station_lb", "w_station_mb2", "w_station_mb1", "w_station_rb" ]
    ],
    "weight": "500",
    "object": {
      "fill_ter": "t_concrete",
      "rows": [
        "NNNNNNNNNNNNNNNNNNNNNNNNNNNNNNNNNNNNNNNNNNNNNNNNNNNNNNNNNNNNNNNNNNNNNNNNNNNNNNNNNNNNNNNNNNNNNNNN",
        "N                                                                                              N",
        "N                                                                                              N",
        "N                                                                                              N",
        "N                                                                                              N",
        "N                                                                                              N",
        "N                                                                                              N",
        "N                                                                                              N",
        "N                                                                                              N",
        "N                                                                                              N",
        "N                                                                                              N",
        "N                                                                                              N",
        "N                                                                                              N",
        "N                                                                                              N",
        "N                                                                                              N",
        "N                                                                                              N",
        "N                                                                                              N",
        "N                                                                                              N",
        "NNNNNNNNNNNNNNNNNNNNNNNNNNNNNNNNNNNNNNNNNNNNNNNNN...NNNNNNNNNNNNNNNNNNNNNNNNNNNNNNNNNNNNNNNNNNNN",
        "N..............................................................................................N",
        "N...............................................................................................",
        "N...............................................................................................",
        "N...............................................................................................",
        "N..........................................................................................NNNNN",
        "N...............................................................................................",
        "N...............................................................................................",
        "N...............................................................................................",
        "N..........................................................................................NNNNN",
        "N...............................................................................................",
        "N...............................................................................................",
        "N...............................................................................................",
        "N.....................................NNNNN................................................NNNNN",
        "N......................................bbb......................................................",
        "N...............................................................................................",
        "N...............................................................................................",
        "N                  ...                 ...                 ...                 ...             N",
        "NlllllWWWWWWWWWWllWWWTWWWWWWWWWWWWWllWWWTWWWWWWWWWWWWWllWWWWTWWWWWWWWWWWWWllWWWWTWWWWWWWWWWWWllN",
        "N   WWW        WWWW12 12 12 12 12 WWWW12 12 12 12 12 WWWW 12 12 12 12 12 WWWW 12 12 12 12 12WW N",
        "N  WW           WW 12 12 12 12 12  WW 12 12 12 12 12  WW  12 12 12 12 12  WW  12 12 12 12 12WW N",
        "N  W            WW 12 12 12 12 12  WW 12 12 12 12 12  WW  12 12 12 12 12  WW  12 12 12 12 12WW N",
        "N  W             T                  T                  T                   T                WW N",
        "N  W             T                  T                  T                   T                WW N",
        "N  W            WW 12 12 12 12 12  WW 12 12 12 12 12  WW  12 12 12 12 12  WW  12 12 12 12 12WW N",
        "N  WW           WW 12 12 12 12 12  WW 12 12 12 12 12  WW  12 12 12 12 12  WW  12 12 12 12 12WW N",
        "N   WWW        WWWW12 12 12 12 12 WWWW12 12 12 12 12 WWWW 12 12 12 12 12 WWWW 12 12 12 12 12WW N",
        "NlllllWWWWWWWWWWllWWWWWWWWWWWWWWWWWllWWWWWWWWWWWWWWWWWllWWWWWWWWWWWWWWWWWWllWWWWWWWWWWWWWWWWWllN",
        "N                                                                                              N",
        "NNNNNNNNNNNNNNNNNNNNNNNNNNNNNNNNNNNNNNNNNNNNNNNNNNNNNNNNNNNNNNNNNNNNNNNNNNNNNNNNNNNNNNNNNNNNNNNN"
      ],
      "faction_owner": [  ],
      "place_npcs": [  ],
      "terrain": {
        "N": "t_wall_b",
        "L": "t_ballistic_glass",
        "l": "t_railroad_track",
        "W": "t_brick_wall",
        ".": "t_concrete",
        "T": "t_door_metal_bulkhead_c",
        "t": "t_door_gray_c",
        "]": "t_door_lab_c",
        "[": "t_door_metal_lab_c",
        "^": "t_stairs_up",
        " ": [ [ "t_grass", 15 ], [ "t_dirt", 1 ], [ "t_grass_dead", 3 ] ],
        "/": "t_linoleum_whitefloor_olight",
        ",": "t_linoleum_gray",
        "=": "t_linoleum_gray_floor_olight",
        "`": "t_linoleum_white",
        "0": "t_grate",
        "1": "t_strconc_floor_olight",
        "2": "t_floor",
        "4": "t_floor_olight",
        "5": "t_carpet_metal_red",
        "6": "t_carpet_red_light"
      },
      "furniture": { "b": "f_bench" }
    }
  }
]
