[
  {
    "type": "mapgen",
    
    "om_terrain": [ [ "ps_lt", "ps_mt", "ps_rt" ], [ "ps_lb", "ps_mb", "ps_rb" ] ],
    "weight": 500,
    "object": {
      "fill_ter": "t_concrete",
      "rows": [
        "                                                                        ",
        "  NNNNNNNNNNNNNNNNNNNNNNNNNNNNNNNNNNNNNNNNNNNNNNNNNNNNNNNNNNNNNNNNNNNNN ",
        "  NNNNNNNNNNNNNNNNNNNNNNNNNNNNNNNNNNNNNNNNNNNNNNNNNNNNNNNNNNNNNNNNNNNNN ",
        "  NN..;;;;;;;;;;;;;;lll....N.....sssssss.....N....hhh.................N ",
        "  NN..;...4................N.....s.ttt.s.....N...httth.......hhh......N ",
        "  NN..;...lll...tttt.......N..4....ttt....4..N...httth......httth.....N ",
        "  NNNNNNNNNNNNDNNNNNNNNNNNNN.................N...httth......httth.....N ",
        "  N........yyyy..yyy.......D.................D....hhh.......httth.....N ",
        "  N..yyyyy...yyy...........N.ttt.4.....4.ttt.N...............hhh......N ",
        "  N..z..z................z.NNNNNNWWNDNWWNNNNNN..........hhh......NNNNNN ",
        "  N..zz.....yy...........z.NCCCCCCCCCCCCCCCCCN.........httth.....Naa.iN ",
        "  N..zz.....yy......zzzzzz.NCCCCCCCCCCCCCCCCCN.........httth.....D.4.uN ",
        "  N.........yy....z.zzzzzNDNCCPPPPPPPPPPPPPCCNDN.......httth.....NNNNNN ",
        "  N.yy..zzzzzz...zy......NCCCPPPPPPPPPPPPPPPCCCN........hhh......Naa.iN ",
        "  N.....zzzzzz...zy......NCCPPPPPPPPPPPPPPPPPCCN.................D.4.uN ",
        "  Nyy.........yy.........NCCPPPPPPPPPPPPPPPPPCCNNNNNNNNNN......NNNNNNNN ",
        "  Nyy.........yy.......NNNCCPPPPPPCCCCCPPPPPPCCNNNbb4leeN......Neel4bbN ",
        "  NNNNNNNNNNDNNNNNNNNNNNCCCPPPPPPCC///CCPPPPPPCCCNd.....D......D.....dN ",
        "  Nth................htNCCPPPPPPPC/////CPPPPPPPCCNNNNNNNN......NNNNNNNN ",
        "  Nth.....hhhhhh.....htNCCPPPPPPPC/////CPPPPPPPCCNbb4leeN......Neel4bbN ",
        "  N......4tttttt4......NCCPPPPPPPC/////CPPPPPPPCCNd.....D......D.....dN ",
        "  Nth.....hhhhhh.....htNCCPPPPPPPC/////CPPPPPPPCCNNNNNNNN......NNNNNNNN ",
        "  Nth................htNCCPPPPPPPCC///CCPPPPPPPCCNbb4leeN......N.dbb.sN ",
        "  NNNNNNNNNNNNNNNNDNNNNNCCPPPPPPPPCCCCCPPPPPPPPCCNd.....D......N..bb.sN ",
        "  Nr....Nccccc...c.....NCCPPPPPPPPPPPPPPPPPPPPPCCNNNNNNNN......Nl.4..hN ",
        "  Nr.rr.Nc.......c.....DCCPPPPPPPPPPPPPPPPPPPPPCCD.............D....eeN ",
        "  Nr.rr4Nf..ccc4.c.....NCCPPPPPPPPPPPPPPPPPPPPPCCNNNNNNNN......NNNNNNNN ",
        "  Nr.rr.Nf..ccc..c.....NCCPPPPPPPPPPPPPPPPPPPPPCCNbb4leeN......Neel4bbN ",
        "  Nr....D..............N#####PPPPPPPPPPPPPPP#####Nd.....D......D.....dN ",
        "  NNNNNNNNNNNNNNNNNNNNNNCCPPPPPPPPPPPPPPPPPPPPPCCNNNNNNNNNNNNNNNNNNNNNN ",
        "                          SSPPPPPPPPPPPPPPPPPSS                         ",
        "                          SSPPPPPPPPPPPPPPPPPSS                         ",
        "                          SSPPPPPPPPPPPPPPPPPSS                         ",
        "                          SSPPPPPPPPPPPPPPPPPSS                         ",
        "                          SSPPPPPPPPPPPPPPPPPSS                         ",
        "                          SSPPPPPPPPPPPPPPPPPSS                         ",
        "                          SSPPPPPPPPPPPPPPPPPSS                         ",
        "                          SSPPPPPPPPPPPPPPPPPSS                         ",
        "                          SSPPPPPPPPPPPPPPPPPSS                         ",
        "                          SSPPPPPPPPPPPPPPPPPSS                         ",
        "                          SSPPPPPPPPPPPPPPPPPSS                         ",
        "                          SSPPPPPPPPPPPPPPPPPSS                         ",
        "                          SSPPPPPPPPPPPPPPPPPSS                         ",
        "                          SSPPPPPPPPPPPPPPPPPSS                         ",
        "                          SSPPPPPPPPPPPPPPPPPSS                         ",
        "                          SSPPPPPPPPPPPPPPPPPSS                         ",
        "                          SSPPPPPPPPPPPPPPPPPSS                         ",
        "                          SSPPPPPPPPPPPPPPPPPSS                         "
      ],
      "faction_owner": [  ],
      "place_npcs": [
        { "class": "bullet_leader_npc", "x": 36, "y": 3 },
        { "class": "bullet_follower_npc", "x": 42, "y": 7 },
        { "class": "bullet_follower_npc", "x": 30, "y": 7 },
        
        { "class": "bullet_follower_npc", "x": 27, "y": 27 },
        { "class": "bullet_follower_npc", "x": 45, "y": 27 },
        { "class": "bullet_follower_npc", "x": 26, "y": 22 },
        { "class": "bullet_follower_npc", "x": 49, "y": 22 },
        { "class": "bullet_follower_npc", "x": 28, "y": 18 },
        { "class": "bullet_follower_npc", "x": 46, "y": 18 },
        
        
        { "class": "bullet_follower_npc", "x": 14, "y": 25 },
        { "class": "bullet_follower_npc", "x": 12, "y": 14 },
        { "class": "bullet_follower_npc", "x": 9, "y": 4 },
        { "class": "bullet_follower_npc", "x": 12, "y": 5 },
        { "class": "bullet_follower_npc", "x": 18, "y": 21 },
        { "class": "bullet_follower_npc", "x": 56, "y": 21 },
        { "class": "bullet_follower_npc", "x": 59, "y": 17 }
        
        
        
      ],
      "terrain": {
        "N": "t_lixa_wall",
        "C": "t_concrete",
        "D": "t_door_c",
        "L": "t_ballistic_glass",
        "#": "t_junk_palisade",
        " ": [ [ "t_grass", 15 ], [ "t_dirt", 1 ], [ "t_grass_dead", 3 ] ],
        "/": [ [ "t_grass", 15 ], [ "t_tree_sassafras", 8 ], [ "t_tree_birch", 4 ] ],
        ".": "t_floor",
        "4": "t_floor_olight",
        "W": "t_window_open",
        "P": "t_pavement",
        "S": "t_sidewalk"
      },
      "furniture": {
        "b": "f_bed",
        "k": "f_bookcase",
        "d": "f_dresser",
        "e": "f_desk",
        "h": "f_chair",
        "r": "f_rack_wood",
        ";": "f_rack",
        "f": "f_fridge",
        "o": "f_oven",
        "c": "f_cupboard",
        "t": "f_table",
        "i": "f_toilet",
        "s": "f_sofa",
        "u": "f_counter",
        "a": "f_bathtub",
        "l": "f_locker",
        "z": "f_crate_c",
        "y": "f_crate_o"
      },
      "items": {
        "b": { "item": "bed", "chance": 30, "repeat": [ 1, 2 ] },
        "k": { "item": "homebooks", "chance": 40, "repeat": [ 1, 4 ] },
        "d": [
          {
            "item": {
              "subtype": "distribution",
              "entries": [ { "group": "SUS_dresser_mens", "prob": 50 }, { "group": "SUS_dresser_womens", "prob": 50 } ]
            }
          }
        ],
        "e": { "item": "softdrinks_canned", "chance": 90, "repeat": [ 1, 5 ] },
        "r": [ { "item": "SUS_pantry", "chance": 25 }, { "item": "cannedfood", "chance": 20, "repeat": [ 1, 2 ] } ],
        ";": { "item": "home_display_case", "chance": 90, "repeat": [ 1, 5 ] },
        "f": { "item": "SUS_fridge", "chance": 80, "repeat": [ 1, 2 ] },
        "c": { "item": "SUS_junk_drawer", "chance": 80, "repeat": [ 1, 2 ] },
        "l": { "item": "unisex_coat_rack", "chance": 80, "repeat": [ 5, 7 ] },
        "z": { "item": "SUS_office_filing_cabinet", "chance": 80, "repeat": [ 1, 2 ] }
      }
    }
  },
  {
    "type": "mapgen",
    
    "om_terrain": [ [ "ps_lt_r", "ps_mt_r", "ps_rt_r" ], [ "ps_lb_r", "ps_mb_r", "ps_rb_r" ] ],
    "weight": 500,
    "object": {
      "fill_ter": "t_concrete",
      "rows": [
        "                                                                        ",
        "  ..................................................................... ",
        "  ..................................................................... ",
        "  ..................................................................... ",
        "  ..................................................................... ",
        "  ..................................................................... ",
        "  ..................................................................... ",
        "  ..................................................................... ",
        "  ..................................................................... ",
        "  ..................................................................... ",
        "  ..................................................................... ",
        "  ..................................................................... ",
        "  ..........................                 .......................... ",
        "  ........................                     ........................ ",
        "  ........................                     ........................ ",
        "  ........................                     ........................ ",
        "  ........................                     ........................ ",
        "  ......................                         ...................... ",
        "  ......................                         ...................... ",
        "  ......................                         ...................... ",
        "  ......................                         ...................... ",
        "  ......................                         ...................... ",
        "  ......................                         ...................... ",
        "  ......................                         ...................... ",
        "  ......................                         ...................... ",
        "  ......................                         ...................... ",
        "  ......................                         ...................... ",
        "  ......................                         ...................... ",
        "  ......................                         ...................... ",
        "  ......................                         ...................... ",
        "                                                                        ",
        "                                                                        ",
        "                                                                        ",
        "                                                                        ",
        "                                                                        ",
        "                                                                        ",
        "                                                                        ",
        "                                                                        ",
        "                                                                        ",
        "                                                                        ",
        "                                                                        ",
        "                                                                        ",
        "                                                                        ",
        "                                                                        ",
        "                                                                        ",
        "                                                                        ",
        "                                                                        ",
        "                                                                        "
      ],
      "faction_owner": [  ],
      "place_npcs": [  ],
      "palettes": [ "roof_palette" ]
    }
  }
]
