[
  {
    "type": "mapgen",
    "method": "json",
    "om_terrain": [ [ "blank2_lt", "blank2_rt" ], [ "blank2_lb", "blank2_rb" ] ],
    "weight": 500,
    "object": {
      "fill_ter": "t_concrete",
      "rows": [
        "                                                ",
        "                                                ",
        "                                                ",
        "                                                ",
        "                                                ",
        "                                                ",
        "                                                ",
        "                                                ",
        "                                                ",
        "                                                ",
        "                                                ",
        "                                                ",
        "                                                ",
        "                                                ",
        "                                                ",
        "                                                ",
        "                                                ",
        "                                                ",
        "                                                ",
        "                                                ",
        "                                                ",
        "                                                ",
        "                                                ",
        "                                                ",
        "                                                ",
        "                                                ",
        "                                                ",
        "                                                ",
        "                                                ",
        "                                                ",
        "                                                ",
        "                                                ",
        "                                                ",
        "                                                ",
        "                                                ",
        "                                                ",
        "                                                ",
        "                                                ",
        "                                                ",
        "                                                ",
        "                                                ",
        "                                                ",
        "                                                ",
        "                                                ",
        "                                                ",
        "                                                ",
        "                                                ",
        "                                                "
      ],
      "faction_owner": [  ],
      "place_npcs": [  ],
      "terrain": {
        "N": "t_concrete",
        "L": "t_ballistic_glass",
        " ": [ [ "t_grass", 15 ], [ "t_dirt", 1 ], [ "t_grass_dead", 3 ] ],
        "3": "t_floor",
        "4": "t_floor_olight"
      },
      "furniture": {  }
    }
  }
]
