[
 {
    "type": "mapgen",
    "method": "json",
    "om_terrain": [ "rc_hideout" ],
	"weight": "500",
    "object": {
      "fill_ter": "t_floor",
      "rows": [
            "NNNNNNNNNNNNNNNNNNNNNNNN",
            "NSSSS     kNrrrkkkkkrrrN",
            "NSttt     kN           N",
            "NSttt !  NNNCCCCCCCCCcCN",
            "NSttt    # N  b b b    N",
            "NSSSS    N N `.`./.`.  N",
            "NNNNNNNNNNTN .`.`.`.`  N",
            "NSttSNAAA    `.`.`.`.  N",
            "NSttSN^^^ !  .`./.`.`  N",
            "NSttSN       `.`.`.`.  N",
            "N !                    N",
            "NNNNN.NNNNN.NNb b bNNN N",
            "N``/````/````N^^^^^NSC N",
            "NSttSN SSS N`NNNNNNNSC N",
            "NSttSNStttSN`NLNLNLNNN!N",
            "NSttSNStttSN`#/```/N # N",
            "NNNNNNNNNNNNNNNNNNNNTNNN",
            "___----------------_____",
            "___----------------_____",
            "___----------------_____",
            "___----------------_____",
            "________________________",
            "________________________",
            "________________________"
            ],
			"place_npcs": [
        { "class": "jikan_npc", "x": 1, "y": 3 },
		{ "class": "rc_npc_bartender", "x": 16, "y": 2 },
		{ "class": "rc_npc_bouncer", "x": 20, "y": 12 },
		{ "class": "rc_npc", "x": 7, "y": 7 },
		{ "class": "rc_duglas", "x": 14, "y": 4 },
		{ "class": "rc_lim", "x": 8, "y": 13 }
		],
			"terrain": {
		"N": "t_brick_wall",
		"O": "t_window_enhanced_noglass",
		"T": "t_door_metal_c_peep",
		"#": "t_door_bar_c",
		"_": "t_sidewalk",
		"-": [ [ "t_grass", 15], [ "t_dirt",1], [ "t_grass_dead", 3],["t_tree_apple", 3] ],
		"/": "t_linoleum_whitefloor_olight",
		"`": "t_linoleum_white",
		".": "t_linoleum_gray",
		"!": "t_floor_olight"
			},
			"furniture": { 
			"C": "f_counter",
			"c": "f_counter_gate_c",
			"k": "f_glass_cabinet",
			"S": "f_sofa",
			"t": "f_table",
			"^": "f_coffee_table",
			"b": "f_barstool",
			"L": "f_toilet",
			"r": "f_rack",
			"A": "f_armchair"
	}
 }
 },
 {
"type": "mapgen",
"method": "json",
"om_terrain": [ "rc_hideout_roof"] ,
"weight": "500",
"object": {
	"fill_ter": "t_flat_roof",
	 "rows": [
            "........................",
            "........................",
            "........................",
            "........................",
            "........................",
            "........................",
            "........................",
            "........................",
            "........................",
            "........................",
            "........................",
            "........................",
            "........................",
            "........................",
            "........................",
            "........................",
            "........................",
            "                        ",
            "                        ",
            "                        ",
            "                        ",
            "                        ",
            "                        ",
            "                        "
            ],
	"palettes": [ "roof_palette" ]	
}
}
]