[
  {
    "type": "mapgen",
    "method": "json",
    "om_terrain": [ [ "blank1_lt", "blank1_mt2", "blank1_mt1", "blank1_rt" ], [ "blank1_lb", "blank1_mb2", "blank1_mb1", "blank1_rb" ] ],
    "weight": 500,
    "object": {
      "fill_ter": "t_concrete",
      "rows": [
        "                                                                                                ",
        "                                                                                                ",
        "                                                                                                ",
        "                                                                                                ",
        "                                                                                                ",
        "                                                                                                ",
        "                                                                                                ",
        "                                                                                                ",
        "                                                                                                ",
        "                                                                                                ",
        "                                                                                                ",
        "                                                                                                ",
        "                                                                                                ",
        "                                                                                                ",
        "                                                                                                ",
        "                                                                                                ",
        "                                                                                                ",
        "                                                                                                ",
        "                                                                                                ",
        "                                                                                                ",
        "                                                                                                ",
        "                                                                                                ",
        "                                                                                                ",
        "                                                                                                ",
        "                                                                                                ",
        "                                                                                                ",
        "                                                                                                ",
        "                                                                                                ",
        "                                                                                                ",
        "                                                                                                ",
        "                                                                                                ",
        "                                                                                                ",
        "                                                                                                ",
        "                                                                                                ",
        "                                                                                                ",
        "                                                                                                ",
        "                                                                                                ",
        "                                                                                                ",
        "                                                                                                ",
        "                                                                                                ",
        "                                                                                                ",
        "                                                                                                ",
        "                                                                                                ",
        "                                                                                                ",
        "                                                                                                ",
        "                                                                                                ",
        "                                                                                                ",
        "                                                                                                "
      ],
      "faction_owner": [  ],
      "place_npcs": [  ],
      "terrain": {
        "N": "t_concrete",
        "L": "t_ballistic_glass",
        " ": [ [ "t_grass", 15 ], [ "t_dirt", 1 ], [ "t_grass_dead", 3 ] ],
        "3": "t_floor",
        "4": "t_floor_olight"
      },
      "furniture": {  }
    }
  }
]
