[
  {
    "type": "mapgen",
    "method": "json",
    "om_terrain": [ "lc_surface" ],
    "weight": "500",
    "object": {
      "fill_ter": "t_concrete",
      "rows": [
        "NNNNNNNNNNNNNNNNNNNNNNNN",
        "N  NNNNNNNNNNNNN       N",
        "N  NNNNNNNNNNNNN       N",
        "N  NNNNN_N_NNNNN!!!    N",
        "N  NNNN.....NNNNN!!    N",
        "N  NNNNNNTNNNNNNNN!!!!!N",
        "N  NNNN.....NNNNNNN```!N",
        "N  NNNN.N.N.T#T#T#T```!N",
        "N  NNNNNNNNNNNNNNNN```!N",
        "N  NNNNNNNNNNNNNNN!```!N",
        "N  NNNNNNNNNNNNNN!!``` 5",
        "N  NNNNNNNNNNNNN!!!``` 5",
        "N                  ``` 5",
        "N    !!!           ``` 5",
        "N    !```````````````` 5",
        "N    !````````````````!N",
        "N    !````````````````!N",
        "N    !!!            !!!N",
        "N                      N",
        "N                      N",
        "N                      N",
        "N                      N",
        "N                      N",
        "NNNNNNNNNNNNNNNNNNNNNNNN"
      ],
      "place_monster": [
        { "group": "PECCA_GENERAL", "x": [ 21, 23 ], "y": [ 5, 12 ], "repeat": 3 },
        { "group": "PECCA_GENERAL", "x": 9, "y": 6, "repeat": 2 }
      ],
      "terrain": {
        "N": "t_wall_bulkhead",
        "O": "t_window_enhanced_noglass",
        "T": "t_door_metal_bulkhead_c",
        "#": "t_door_bar_c",
        "_": "t_stairs_down",
        " ": "t_metal_floor_no_roof",
        "/": "t_linoleum_whitefloor_olight",
        "`": "t_pavement",
        ".": "t_concrete",
        "!": "t_concrete",
        "5": "t_retractable_gate_c"
      }
    }
  },
  {
    "type": "mapgen",
    "method": "json",
    "om_terrain": [ "lc_surface_roof" ],
    "weight": "500",
    "object": {
      "fill_ter": "t_concrete",
      "rows": [
        "   .............        ",
        "   .............        ",
        "   .............        ",
        "   .............        ",
        "   ..............       ",
        "   ...............      ",
        "   ................     ",
        "   ................     ",
        "   ................     ",
        "   ...............      ",
        "   ..............       ",
        "   .............        ",
        "                        ",
        "                        ",
        "                        ",
        "                        ",
        "                        ",
        "                        ",
        "                        ",
        "                        ",
        "                        ",
        "                        ",
        "                        ",
        "                        "
      ],
      "palettes": [ "roof_palette" ]
    }
  },
  {
    "type": "mapgen",
    "method": "json",
    "om_terrain": [ "lc_mid" ],
    "weight": "500",
    "object": {
      "fill_ter": "t_concrete",
      "rows": [
        "                        ",
        "         NNN            ",
        "         N_N            ",
        "        NNTNN           ",
        "       NN...NN          ",
        "       N..N..N          ",
        "       NN...NN          ",
        "        NNTNN           ",
        "         N#N            ",
        "         NNN            ",
        "                        ",
        "                        ",
        "                        ",
        "                        ",
        "                        ",
        "                        ",
        "                        ",
        "                        ",
        "                        ",
        "                        ",
        "                        ",
        "                        ",
        "                        ",
        "                        "
      ],
      "place_monster": [
        { "group": "PECCA_GENERAL", "x": 8, "y": 5, "repeat": 1 },
        { "group": "PECCA_GENERAL", "x": 12, "y": 5, "repeat": 1 }
      ],
      "terrain": {
        "N": "t_wall_bulkhead",
        "O": "t_window_enhanced_noglass",
        "T": "t_door_metal_bulkhead_c",
        "#": "t_stairs_down",
        "_": "t_stairs_up",
        " ": "t_soil",
        "/": "t_linoleum_whitefloor_olight",
        "`": "t_pavement",
        ".": "t_concrete",
        "!": "t_concrete"
      }
    }
  },
  {
    "type": "mapgen",
    "method": "json",
    "om_terrain": [
      [ "lc_lab1_lt", "lc_lab1_mt2", "lc_lab1_mt1", "lc_lab1_rt" ],
      [ "lc_lab1_lb", "lc_lab1_mb2", "lc_lab1_mb1", "lc_lab1_rb" ]
    ],
    "weight": "500",
    "object": {
      "fill_ter": "t_concrete",
      "rows": [
        "        NNNNNNNNNNNNNNNNNNNNN       NNNNNNNNNNNNNNNNNNNN       NNNNNNNNNNNNNNNNNNNNN            ",
        "        N00/////11.........qN       NNNNNNNv.NN.^NNNNNNN       Nq.........11/////00N            ",
        "        N00/////11.........qN       NqqqqqNv....^NqqqqqN       Nq.........11/////00N            ",
        "        N///////11........NNN       N`````N`N..N,,,,,,,N       NNN........11///////N            ",
        "        N///////11........T=N       N```````NTTN,,,,,,,N       N=T........11///////N            ",
        "        NNNNNNNNNNNNNNNNNNNTNNNNNNNNNNNNNNNNN==NNNNNNNNNNNNNNNNNTNNNNNNNNNNNNNNNNNNN            ",
        "                         N=====0====0==================0====0=====N                             ",
        "                         N=====000000==================000000=====N                             ",
        "        NNNNNNNNNNNNNNNNNNNTNNNNNNNNWWWWWWWWW==WWWWWWWWWNNNNNNNNTNNNNNNNNNNNNNNNNNNN            ",
        "        N///////11........T=N               W[ W               N=T........11///////N            ",
        "        N///////11........NNN                                  NNN........11///////N            ",
        "        N00/////11.........qN                                  Nq.........11/////00N            ",
        "        N00/////11.........qN                                  Nq.........11/////00N            ",
        "        NNNNNNNNNNNNNNNNNNNNN                                  NNNNNNNNNNNNNNNNNNNNN            ",
        "                                                                                                ",
        "                                                                                                ",
        "                                                                                                ",
        "                                                                                                ",
        "                                                                                                ",
        "                                                                                                ",
        "                                                                                                ",
        "                                                                                                ",
        "                                                                                                ",
        "                                                                                                ",
        "                                                                                                ",
        "                                                                                                ",
        "                                                                                                ",
        "                                                                                                ",
        "                                                                                                ",
        "                                                                                                ",
        "                                                                                                ",
        "                                                                                                ",
        "                                                                                                ",
        "                                                                                                ",
        "                                                                                                ",
        "                                                                                                ",
        "                                                                                                ",
        "                                                                                                ",
        "                                                                                                ",
        "                                                                                                ",
        "                                                                                                ",
        "                                                                                                ",
        "                                                                                                ",
        "                                                                                                ",
        "                                                                                                ",
        "                                                                                                ",
        "                                                                                                ",
        "                                                                                                "
      ],
      "place_npcs": [  ],
      "terrain": {
        "N": "t_wall_bulkhead",
        "L": "t_wall_metal",
        "l": "t_strconc_wall_w",
        "W": "t_brick_wall",
        "z": "t_strconc_wall_r",
        "T": "t_door_metal_bulkhead_c",
        "t": "t_door_gray_c",
        "]": "t_door_lab_c",
        "[": "t_door_metal_lab_c",
        "G": "t_ballistic_glass",
        "^": "t_stairs_up",
        "v": "t_stairs_up",
        " ": "t_rock",
        "/": "t_strconc_floor",
        ",": "t_linoleum_gray",
        "=": "t_metal_floor",
        "`": "t_linoleum_white",
        ".": "t_concrete",
        "0": "t_grate",
        "1": "t_pavement_y",
        "3": "t_floor",
        "4": "t_floor_olight",
        "5": "t_carpet_metal_red",
        "6": "t_carpet_red_light"
      },
      "furniture": {
        "q": "f_locker",
        "h": "f_desk",
        "n": "f_chair_black",
        "i": "f_chair",
        "A": "f_armchair",
        "B": "f_bookcase",
        "S": "f_sofa",
        "f": "f_table",
        "+": "f_dresser",
        "b": "f_bed",
        "r": "f_rack",
        "2": "f_toilet",
        "s": "f_sink",
        "@": "f_metal_trashcan",
        "o": "f_glass_cabinet",
        "!": "f_bulletin",
        "|": "f_counter",
        "&": "f_lab_bench",
        "~": "f_cupboard",
        "*": "f_oven",
        "F": "f_fridge",
        "%": "f_workbench",
        "J": "f_slab",
        "9": "f_console"
      }
    }
  },
  {
    "type": "mapgen",
    "method": "json",
    "om_terrain": [
      [ "lc_lab2_lt", "lc_lab2_mt2", "lc_lab2_mt1", "lc_lab2_rt" ],
      [ "lc_lab2_lb", "lc_lab2_mb2", "lc_lab2_mb1", "lc_lab2_rb" ]
    ],
    "weight": "500",
    "object": {
      "fill_ter": "t_concrete",
      "rows": [
        "        NNNNNNNNNNNNNNNNNNNNN       NNNNNNNNNNNNNNNNNNNN            NNNNNNNNNNNNNNN             ",
        "        N00/////11.........qN       NNNNNNNv.NN.^NNNNNNN            N**=0002000=**N             ",
        "        N00/////11.........qN       NqqqqqNv....^Nq qqqN            N**=1=====1=**N             ",
        "        N///////11........NNN       N`````N N..N,  , ,,N            N============ N             ",
        "        N///////11........  N       N```````NTTN ,,  ,,N            N=====***=====N             ",
        "        NNNNNNNNNNNNNNNNNN TNNNNNNNNNNNNNNNNN==NNNNNNNNNNNNNNNNNNNNNN===1=====1===N             ",
        "                         N   ==0====0 ======== ========0====0====0T=T=============N             ",
        "                         N= ===000000==== === == ======000000=== 0T=T=====***=====N             ",
        "        NNNNNNNNNNNNNNNNNNN  NNNNNNNNNNNNNNNN =NNNNNNNNNNNNNNNN NNNNN===1=====1===N             ",
        "        N///////11........T=N               NT N                    N======*==== =N             ",
        "        N///////11........NNN                                       N==  =========N             ",
        "        N00/////11.........qN                                       NNNNNNNNNNNNNNN             ",
        "        N00/////11.........qN                                                                   ",
        "        NNNNNNNNNNNNNNNNNNNNN                                                                   ",
        "                                                                                                ",
        "                                                                                                ",
        "                                                                                                ",
        "                                                                                                ",
        "                                                                                                ",
        "                                                                                                ",
        "                                                                                                ",
        "                                                                                                ",
        "                                                                                                ",
        "                                                                                                ",
        "                                                                                                ",
        "                                                                                                ",
        "                                                                                                ",
        "                                                                                                ",
        "                                                                                                ",
        "                                                                                                ",
        "                                                                                                ",
        "                                                                                                ",
        "                                                                                                ",
        "                                                                                                ",
        "                                                                                                ",
        "                                                                                                ",
        "                                                                                                ",
        "                                                                                                ",
        "                                                                                                ",
        "                                                                                                ",
        "                                                                                                ",
        "                                                                                                ",
        "                                                                                                ",
        "                                                                                                ",
        "                                                                                                ",
        "                                                                                                ",
        "                                                                                                ",
        "                                                                                                "
      ],
      "place_npcs": [  ],
      "terrain": {
        "N": "t_wall_bulkhead",
        "L": "t_wall_metal",
        "l": "t_strconc_wall_w",
        "W": "t_brick_wall",
        "z": "t_strconc_wall_r",
        "T": "t_door_metal_bulkhead_c",
        "t": "t_door_gray_c",
        "]": "t_door_lab_c",
        "[": "t_door_metal_lab_c",
        "G": "t_ballistic_glass",
        "^": "t_stairs_up",
        "v": "t_stairs_up",
        " ": "t_rock",
        "/": "t_strconc_floor",
        ",": "t_linoleum_gray",
        "=": "t_metal_floor",
        "`": "t_linoleum_white",
        ".": "t_concrete",
        "0": "t_grate",
        "1": "t_thconc_r",
        "3": "t_floor",
        "4": "t_floor_olight",
        "5": "t_carpet_metal_red",
        "6": "t_carpet_red_light"
      },
      "furniture": {
        "q": "f_locker",
        "h": "f_desk",
        "n": "f_chair_black",
        "i": "f_chair",
        "A": "f_armchair",
        "B": "f_bookcase",
        "S": "f_sofa",
        "f": "f_table",
        "+": "f_dresser",
        "b": "f_bed",
        "r": "f_rack",
        "2": "t_marble_floor",
        "s": "f_sink",
        "@": "f_metal_trashcan",
        "o": "f_glass_cabinet",
        "!": "f_bulletin",
        "|": "f_counter",
        "&": "f_lab_bench",
        "~": "f_cupboard",
        "*": "f_generator_broken",
        "F": "f_fridge",
        "%": "f_workbench",
        "J": "f_slab",
        "9": "f_console"
      }
    }
  }
]
