[
  {
    "type": "mapgen",
    "method": "json",
    "om_terrain": [ "lab_ab_surface" ],
    "weight": "500",
    "object": {
      "fill_ter": "t_concrete",
      "rows": [
        "NNNNNNNNNNNNNNNNNNNNNNNN",
        "N  NNNNNNNNNNNNN       N",
        "N  NNNNNNNNNNNNN       N",
        "N  NNNNN_N_NNNNN!!!    N",
        "N  NNNN.....NNNNN!!    N",
        "N  NNNNNNTNNNNNNNN!!!!!N",
        "N  NNNN.....NNNNNNN```!N",
        "N  NNNN.N.N.T#T#T#T```!N",
        "N  NNNNNNNNNNNNNNNN```!N",
        "N  NNNNNNNNNNNNNNN!```!N",
        "N  NNNNNNNNNNNNNN!!``` 5",
        "N  NNNNNNNNNNNNN!!!``` 5",
        "N                  ``` 5",
        "N    !!!           ``` 5",
        "N    !```````````````` 5",
        "N    !````````````````!N",
        "N    !````````````````!N",
        "N    !!!            !!!N",
        "N                      N",
        "N                      N",
        "N                      N",
        "N                      N",
        "N                      N",
        "NNNNNNNNNNNNNNNNNNNNNNNN"
      ],
      "place_monster": [
        { "group": "PECCA_GENERAL", "x": [ 21, 23 ], "y": [ 5, 12 ], "repeat": 3 },
        { "group": "PECCA_GENERAL", "x": 9, "y": 6, "repeat": 2 }
      ],
      "terrain": {
        "N": "t_wall_bulkhead",
        "O": "t_window_enhanced_noglass",
        "T": "t_door_metal_bulkhead_c",
        "#": "t_door_bar_c",
        "_": "t_stairs_down",
        " ": "t_metal_floor_no_roof",
        "/": "t_linoleum_whitefloor_olight",
        "`": "t_pavement",
        ".": "t_concrete",
        "!": "t_concrete",
        "5": "t_retractable_gate_c"
      }
    }
  },
  {
    "type": "mapgen",
    "method": "json",
    "om_terrain": [ "lab_ab_surface_roof" ],
    "weight": "500",
    "object": {
      "fill_ter": "t_concrete",
      "rows": [
        "   .............        ",
        "   .............        ",
        "   .............        ",
        "   .............        ",
        "   ..............       ",
        "   ...............      ",
        "   ................     ",
        "   ................     ",
        "   ................     ",
        "   ...............      ",
        "   ..............       ",
        "   .............        ",
        "                        ",
        "                        ",
        "                        ",
        "                        ",
        "                        ",
        "                        ",
        "                        ",
        "                        ",
        "                        ",
        "                        ",
        "                        ",
        "                        "
      ],
      "palettes": [ "roof_palette" ]
    }
  },
  {
    "type": "mapgen",
    "method": "json",
    "om_terrain": [ "lab_ab_mid" ],
    "weight": "500",
    "object": {
      "fill_ter": "t_concrete",
      "rows": [
        "                        ",
        "         NNN            ",
        "         N_N            ",
        "        NNTNN           ",
        "       NN...NN          ",
        "       N..N..N          ",
        "       NN...NN          ",
        "        NNTNN           ",
        "         N#N            ",
        "         NNN            ",
        "                        ",
        "                        ",
        "                        ",
        "                        ",
        "                        ",
        "                        ",
        "                        ",
        "                        ",
        "                        ",
        "                        ",
        "                        ",
        "                        ",
        "                        ",
        "                        "
      ],
      "place_monster": [
        { "group": "PECCA_GENERAL", "x": 8, "y": 5, "repeat": 1 },
        { "group": "PECCA_GENERAL", "x": 12, "y": 5, "repeat": 1 }
      ],
      "terrain": {
        "N": "t_wall_bulkhead",
        "O": "t_window_enhanced_noglass",
        "T": "t_door_metal_bulkhead_c",
        "#": "t_stairs_down",
        "_": "t_stairs_up",
        " ": "t_soil",
        "/": "t_linoleum_whitefloor_olight",
        "`": "t_pavement",
        ".": "t_concrete",
        "!": "t_concrete"
      }
    }
  },
  {
    "type": "mapgen",
    "method": "json",
    "om_terrain": [ [ "lab_ab_lt", "lab_ab_mt2", "lab_ab_mt1", "lab_ab_rt" ], [ "lab_ab_lb", "lab_ab_mb2", "lab_ab_mb1", "lab_ab_rb" ] ],
    "weight": "500",
    "object": {
      "fill_ter": "t_concrete",
      "rows": [
        "                 NNNNNNNNNNNN       NNNNNNNNNNNNNNNNNNNN       NNNNNNNNNNNN                     ",
        "                 N///1.....qN       NNNNNNNv NN.^NNNNNNN       Nq.....1///N                     ",
        "                 N///1.....qN       NqqqqqN . ..^NqqqqqN       Nq.....1///N                     ",
        "                 N///1....NNN       N`````N`N..N,,,,,,,N       NNN ...1///N                     ",
        "                 N0//1....H=N       N```````NTTN,,,,,,,N       N T ...1//0N                     ",
        "                 NNNNNNNNNtHNNNNNNNNNNNNNNNNN==NNNNNNNNNNNNNNNNNTNNNNNNNNNN                     ",
        "                         N=====0====0========= ========0====0=====N                             ",
        "                         N=====000000==================000000=====N                             ",
        "                 NNNNNNNNNbZNNNNNNNNWWWWWWWWW==WWWWWWWWWNNNNNNNNHtNNNNNNNNN                     ",
        "                 N0//1....Z=N               W[ W               N=H....1//0N                     ",
        "                 N///1....NNN                                  NNN....1/+/N                     ",
        "                 N///1.....qN                                  Nq.....1///N                     ",
        "                 N///1.....qN                                  Nq.....1///N                     ",
        "                 NNNNNNNNNNNN                                  NNNNNNNNNNNN                     ",
        "                                                                                                ",
        "                                                                                                ",
        "                                                                                                ",
        "                                                                                                ",
        "                                                                                                ",
        "                                                                                                ",
        "                                                                                                ",
        "                                                                                                ",
        "                                                                                                ",
        "                                                                                                ",
        "                                                                                                ",
        "                                                                                                ",
        "                                                                                                ",
        "                                                                                                ",
        "                                                                                                ",
        "                                                                                                ",
        "                                                                                                ",
        "                                                                                                ",
        "                                                                                                ",
        "                                                                                                ",
        "                                                                                                ",
        "                                                                                                ",
        "                                                                                                ",
        "                                                                                                ",
        "                                                                                                ",
        "                                                                                                ",
        "                                                                                                ",
        "                                                                                                ",
        "                                                                                                ",
        "                                                                                                ",
        "                                                                                                ",
        "                                                                                                ",
        "                                                                                                ",
        "                                                                                                "
      ],
      "place_npcs": [  ],
      "place_monster": [ { "monster": "mon_birb", "x": 19, "y": 2 } ],
      "place_item": [
        { "item": "p_bird_book", "x": 27, "y": 2, "amount": 1, "chance": 100 },
        { "item": "soda_book", "x": 27, "y": 12, "amount": 1, "chance": 100 }
      ],
      "items": { "+": { "item": "skin_book_placement", "chance": 100 } },
      "terrain": {
        "N": "t_wall_bulkhead",
        "Z": "t_strconc_wall_g",
        "H": "t_strconc_wall_b",
        "L": "t_wall_metal",
        "l": "t_strconc_wall_w",
        "W": "t_brick_wall",
        "z": "t_l_corp_card_reader_zayin",
        "T": "t_door_metal_bulkhead_c",
        "t": "t_l_corp_card_reader_teth",
        "]": "t_door_lab_c",
        "[": "t_door_metal_lab_c",
        "G": "t_ballistic_glass",
        "^": "t_stairs_up",
        "v": "t_stairs_down",
        " ": "t_rock",
        "/": "t_strconc_floor",
        ",": "t_linoleum_gray",
        "=": "t_metal_floor",
        "`": "t_linoleum_white",
        "b": "t_l_corp_card_reader_broken",
        ".": "t_concrete",
        "0": "t_grate",
        "1": "t_pavement_y",
        "3": "t_floor",
        "4": "t_floor_olight",
        "5": "t_carpet_metal_red",
        "6": "t_carpet_red_light"
      },
      "furniture": {
        "q": "f_locker",
        "h": "f_desk",
        "n": "f_chair_black",
        "i": "f_chair",
        "A": "f_armchair",
        "B": "f_bookcase",
        "S": "f_sofa",
        "f": "f_table",
        "+": "f_flesh_pedestal",
        "r": "f_rack",
        "2": "f_toilet",
        "s": "f_sink",
        "@": "f_metal_trashcan",
        "o": "f_glass_cabinet",
        "!": "f_bulletin",
        "|": "f_counter",
        "&": "f_lab_bench",
        "~": "f_cupboard",
        "*": "f_oven",
        "F": "f_fridge",
        "%": "f_workbench",
        "J": "f_slab",
        "9": "f_console"
      }
    }
  },
  {
    "type": "mapgen",
    "method": "json",
    "om_terrain": [
      [ "lab_ab_second_lt", "lab_ab_second_mt2", "lab_ab_second_mt1", "lab_ab_second_rt" ],
      [ "lab_ab_second_lb", "lab_ab_second_mb2", "lab_ab_second_mb1", "lab_ab_second_rb" ]
    ],
    "weight": "500",
    "object": {
      "fill_ter": "t_metal_floor",
      "rows": [
        "                 NNNNNNNNNNNN       NNNNNNNNNNNNNNNNNNNN            NNNNNNNNNNNNNNN             ",
        "                 N///1.....qN       NNNNNNN^.NN.vNNNNNNN            N**066606660**N             ",
        "                 N///1.....qN       NqqqqqN^....vNq qqqN            N**0*==2===0**N             ",
        "                 N///1....NNN       N`````N N..N,  , ,,N            N===6=====6==               ",
        "                 N0//1....  N       N```````NTTN ,,  ,,N          NNN=====***=====N             ",
        "                 NNNNNNNNN TNNNNNNNNNNNNNNNNN==NNNNNNNNNNNNNNNNNNNN6N=============N             ",
        "                         N   ==0====0 ======== ========0====0====08=T===1=====1===N             ",
        "                         N= ===000000==== === == ======000000=== 08=T======**=====N             ",
        "                 NNNNNNNNNN  NNNNNNNNNNNNNNNN =NNNNNNNNNNNNNNNN NN?6N==== ========N             ",
        "                 N0//1....T=N               NT N                  NNN======*==== =N             ",
        "                 N///1....NNN                                       N== 1===*=1===N             ",
        "                 N///1.....qN                                       N=== =**======N             ",
        "                 N///1.....qN                                       N=====*=======N             ",
        "                 NNNNNNNNNNNN                                       N=**===*======N             ",
        "                                                                    N===1=====1===N             ",
        "                                                                    N===== =======N             ",
        "                                                                    N=====  ======N             ",
        "                                                                    N=============N             ",
        "                                                                    NNNNNNNNNNNNNNN             ",
        "                                                                                                ",
        "                                                                                                ",
        "                                                                                                ",
        "                                                                                                ",
        "                                                                                                ",
        "                                                                                                ",
        "                                                                                                ",
        "                                                                                                ",
        "                                                                                                ",
        "                                                                                                ",
        "                                                                                                ",
        "                                                                                                ",
        "                                                                                                ",
        "                                                                                                ",
        "                                                                                                ",
        "                                                                                                ",
        "                                                                                                ",
        "                                                                                                ",
        "                                                                                                ",
        "                                                                                                ",
        "                                                                                                ",
        "                                                                                                ",
        "                                                                                                ",
        "                                                                                                ",
        "                                                                                                ",
        "                                                                                                ",
        "                                                                                                ",
        "                                                                                                ",
        "                                                                                                "
      ],
      "place_npcs": [  ],
      "place_monster": [ { "monster": "mon_watchdog_initial", "x": 75, "y": 2 } ],
      "terrain": {
        "N": "t_wall_bulkhead",
        "L": "t_wall_metal",
        "l": "t_strconc_wall_w",
        "?": "t_l_corp_card_reader_he",
        "W": "t_brick_wall",
        "z": "t_strconc_wall_r",
        "T": "t_door_metal_bulkhead_c",
        "t": "t_door_gray_c",
        "]": "t_door_lab_c",
        "[": "t_door_metal_lab_c",
        "G": "t_ballistic_glass",
        "^": "t_stairs_up",
        "v": "t_stairs_down",
        " ": "t_rock",
        "/": "t_strconc_floor",
        ",": "t_linoleum_gray",
        "=": "t_metal_floor",
        "`": "t_linoleum_white",
        ".": "t_concrete",
        "0": "t_grate",
        "1": "t_thconc_r",
        "3": "t_floor",
        "4": "t_floor_olight",
        "5": "t_carpet_metal_red",
        "6": "t_current_trans",
        "2": "t_marble_floor",
        "8": "t_concrete_wall_y"
      },
      "furniture": {
        "q": "f_locker",
        "h": "f_desk",
        "n": "f_chair_black",
        "i": "f_chair",
        "A": "f_armchair",
        "B": "f_bookcase",
        "S": "f_sofa",
        "f": "f_table",
        "+": "f_dresser",
        "b": "f_bed",
        "r": "f_rack",
        "s": "f_sink",
        "@": "f_metal_trashcan",
        "o": "f_glass_cabinet",
        "!": "f_bulletin",
        "|": "f_counter",
        "&": "f_lab_bench",
        "~": "f_cupboard",
        "*": "f_generator_broken",
        "F": "f_fridge",
        "%": "f_workbench",
        "J": "f_slab",
        "9": "f_console"
      }
    }
  }
]
