[
    {
       "type": "mapgen",
       "method": "json",
       "om_terrain": [ "lc_surface" ],
       "weight": "500",
       "object": {
         "fill_ter": "t_concrete",
         "rows": [
            "   NNNNNNNNNNNNN        ",
            "   NNNNNNNNNNNNN        ",
            "   NNNNNNNNNNNNN        ",
            "   NNNNN_N_NNNNN!!!     ",
            "   NNNN.....NNNNN!!     ",
            "   NNNNNNTNNNNNNNN!!!!!!",
            "   NNNN.....NNNNNNN`````",
            "   NNNN.N.N.T#T#T#T`````",
            "   NNNNNNNNNNNNNNNN`````",
            "   NNNNNNNNNNNNNNN!```!!",
            "   NNNNNNNNNNNNNN!!```  ",
            "   NNNNNNNNNNNNN!!!```  ",
            "                   ```  ",
            "     !!!           ```  ",
            "     !````````````````  ",
            "     !````````````````! ",
            "     !````````````````! ",
            "     !!!            !!! ",
            "                        ",
            "                        ",
            "                        ",
            "                        ",
            "                        ",
            "                        "
            ],
            "terrain": {
                "N": "t_wall_bulkhead",
                "O": "t_window_enhanced_noglass",
                "T": "t_door_metal_bulkhead_c",
                "#": "t_door_bar_c",
                "_": "t_stairs_down",
                " ": "t_metal_floor_no_roof",
                "/": "t_linoleum_whitefloor_olight",
                "`": "t_pavement",
                ".": "t_concrete",
                "!": "t_concrete"
                    }
       }
    },
    {
        "type": "mapgen",
        "method": "json",
        "om_terrain": [ "lc_mid" ],
        "weight": "500",
        "object": {
          "fill_ter": "t_concrete",
          "rows": [
            "                        ",
            "         NNN            ",
            "         N_N            ",
            "        NNTNN           ",
            "        N...N           ",
            "        N...N           ",
            "        N...N           ",
            "        NNTNN           ",
            "         N#N            ",
            "         NNN            ",
            "                        ",
            "                        ",
            "                        ",
            "                        ",
            "                        ",
            "                        ",
            "                        ",
            "                        ",
            "                        ",
            "                        ",
            "                        ",
            "                        ",
            "                        ",
            "                        "
            ],
             "terrain": {
                 "N": "t_wall_bulkhead",
                 "O": "t_window_enhanced_noglass",
                 "T": "t_door_metal_bulkhead_c",
                 "#": "t_stairs_down",
                 "_": "t_stairs_up",
                 " ": "t_soil",
                 "/": "t_linoleum_whitefloor_olight",
                 "`": "t_pavement",
                 ".": "t_concrete",
                 "!": "t_concrete"
                     }
        }
     },
     {
        "type": "mapgen",
        "method": "json",
        "om_terrain": [ ["lc_lab_lt", "lc_lab_mt", "lc_lab_rt" ],
                        ["lc_lab_lb", "lc_lab_mb", "lc_lab_rb" ] ],
        "weight": "500",
        "object": {
          "fill_ter": "t_concrete",
          "rows": [
            "                                                                                                ",
            "                                                                                                ",
            "                                                                                                ",
            "                                                                                                ",
            "                                                                                                ",
            "                                                                                                ",
            "                                                                                                ",
            "                                                                                                ",
            "                                                                                                ",
            "                                                                                                ",
            "                                                                                                ",
            "                                                                                                ",
            "                                                                                                ",
            "                                                                                                ",
            "                                                                                                ",
            "                                                                                                ",
            "                                                                                                ",
            "                                                                                                ",
            "                                                                                                ",
            "                                                                                                ",
            "                                                                                                ",
            "                                                                                                ",
            "                                                                                                ",
            "                                                                                                ",
            "                                                                                                ",
            "                                                                                                ",
            "                                                                                                ",
            "                                                                                                ",
            "                                                                                                ",
            "                                                                                                ",
            "                                                                                                ",
            "                                                                                                ",
            "                                                                                                ",
            "                                                                                                ",
            "                                                                                                ",
            "                                                                                                ",
            "                                                                                                ",
            "                                                                                                ",
            "                                                                                                ",
            "                                                                                                ",
            "                                                                                                ",
            "                                                                                                ",
            "                                                                                                ",
            "                                                                                                ",
            "                                                                                                ",
            "                                                                                                ",
            "                                                                                                ",
            "                                                                                                "
            ],
        "terrain": {
            "N": "t_wall_bulkhead",
            "O": "t_window_enhanced_noglass",
            "T": "t_door_metal_bulkhead_c",
            "#": "t_stairs_down",
            "_": "t_stairs_up",
            " ": "t_soil",
            "/": "t_linoleum_whitefloor_olight",
            "`": "t_pavement",
            ".": "t_concrete",
            "!": "t_concrete"
                }
     }
    }
]