[
    {
       "type": "mapgen",
       "method": "json",
       "om_terrain": [ "lc_surface" ],
       "weight": "500",
       "object": {
         "fill_ter": "t_concrete",
         "rows": [
            "   NNNNNNNNNNNNN        ",
            "   NNNNNNNNNNNNN        ",
            "   NNNNNNNNNNNNN        ",
            "   NNNNN_N_NNNNN!!!     ",
            "   NNNN.....NNNNN!!     ",
            "   NNNNNNTNNNNNNNN!!!!!!",
            "   NNNN.....NNNNNNN`````",
            "   NNNN.N.N.T#T#T#T`````",
            "   NNNNNNNNNNNNNNNN`````",
            "   NNNNNNNNNNNNNNN!```!!",
            "   NNNNNNNNNNNNNN!!```  ",
            "   NNNNNNNNNNNNN!!!```  ",
            "                   ```  ",
            "     !!!           ```  ",
            "     !````````````````  ",
            "     !````````````````! ",
            "     !````````````````! ",
            "     !!!            !!! ",
            "                        ",
            "                        ",
            "                        ",
            "                        ",
            "                        ",
            "                        "
            ],
            "terrain": {
                "N": "t_wall_bulkhead",
                "O": "t_window_enhanced_noglass",
                "T": "t_door_metal_bulkhead_c",
                "#": "t_door_bar_c",
                "_": "t_stairs_down",
                " ": "t_metal_floor_no_roof",
                "/": "t_linoleum_whitefloor_olight",
                "`": "t_pavement",
                ".": "t_concrete",
                "!": "t_concrete"
                    }
       }
    },
    {
        "type": "mapgen",
        "method": "json",
        "om_terrain": [ "lc_mid" ],
        "weight": "500",
        "object": {
          "fill_ter": "t_concrete",
          "rows": [
            "                        ",
            "         NNN            ",
            "         N_N            ",
            "        NNTNN           ",
            "        N...N           ",
            "        N...N           ",
            "        N...N           ",
            "        NNTNN           ",
            "         N#N            ",
            "         NNN            ",
            "                        ",
            "                        ",
            "                        ",
            "                        ",
            "                        ",
            "                        ",
            "                        ",
            "                        ",
            "                        ",
            "                        ",
            "                        ",
            "                        ",
            "                        ",
            "                        "
            ],
             "terrain": {
                 "N": "t_wall_bulkhead",
                 "O": "t_window_enhanced_noglass",
                 "T": "t_door_metal_bulkhead_c",
                 "#": "t_stairs_down",
                 "_": "t_stairs_up",
                 " ": "t_soil",
                 "/": "t_linoleum_whitefloor_olight",
                 "`": "t_pavement",
                 ".": "t_concrete",
                 "!": "t_concrete"
                     }
        }
     },
     {
        "type": "mapgen",
        "method": "json",
        "om_terrain": [ ["lc_lab_lt", "lc_lab_mt2", "lc_lab_mt1", "lc_lab_rt" ],
                        ["lc_lab_lb", "lc_lab_mb2", "lc_lab_mb1", "lc_lab_rb" ] ],
        "weight": "500",
        "object": {
          "fill_ter": "t_concrete",
          "rows": [
            "        WWWWWWWWWWWWWWWWWWW               NNNNNNNN                    llllllllllllllllllll      ",
            "        WBBBvvvWhv hvhhvhhW         NNNNNNN..NN.^NNNNNNN              l                  l      ",
            "        W      Wn  n  n  nW         NqqqqqN.....^NqqqqqN              l                  l      ",
            "        WAh    t         nWWWWWWWWWWN     NNN//NNN     Nllllllllllllllll                ll      ",
            "        W h    W   nh  vhhW         T     T......T     T           [   l                l       ",
            "    WWWWWWWWWWWWWGGGGGtGGWW   NNNNNNNNNTNNNNNNNNNNNNTNNNNNNNNNNNNNNN   llllllllll[llllllll      ",
            "    Wq/t                      N                    N   N           N                l    l      ",
            "    WWWWWWWWWWtWWWWWWWWWWWW   N                    N   T           N                [    lll    ",
            "           W     WBBBAhA vW   N                    N   N           Nllllllllllll    l      l    ",
            "           W v v W        t   N                    N   N           N           l    l      l    ",
            "           W v v WS      AW   N                    NTNNNNNNNNNNNNNNN           l    l      l    ",
            "           W v v WS      hG   N                    N               N         lll    llllllllllll",
            "           WvvvvvWSSS    AW   N                    N               N         l           l     l",
            "WWWWWWWWWWWWWWWWWWWWWWGGGWW   N                    N               N         l           l     l",
            "WhbbWhbbWhbbWhbbWhbbW         N                    N               N         l           l     l",
            "Wn +Wn +Wn +Wn +Wn +W   W    WNNNNNNNNNTNNNNNNNNNNNN               N         l           l     l",
            "W   W   W   W   W   W   WffffW  ,W,  N    G        N               N         lllllllll[llllll[ll",
            "WWtWWWtWWWtWWWtWWWtWW   WWWWWW   W   N    G        NNNNNNNNNNNNNNNNN            l              l",
            "W                       W    W  WWWW N    G                        N            l              l",
            "W                            W       N    T                        N            l              l",
            "WWtWWWtWWWtWWWtWWWtWW        WWWW WWWN    G                        N            l              l",
            "W   W   W   W   W   WWWWW    t       N    G                        N            l              l",
            "W+ nW+ nW+ nW+ nW+ nW   W    W       N    G                        N            l              l",
            "WbbhWbbhWbbhWbbhWbbhW   WWWWWWWWWWWWWNTTNNNNNNNNNNNNNNNNNNNNNNNNNNNN            l              l",
            "WWWWWWWWWWWWWWWWWWWWW                z  z                                       l              l",
            "                                     z  z                                       l              l",
            "          zzzzzzzzzzzzzzz            z  z                                       l              l",
            "          z             z            z  z                                       l              l",
            "          z             zzzzzzzzzzzzzzttzzzzzzzzz                               llllllllllllllll",
            "          z          zzzz                       z                                               ",
            "          z    z[z   z  z                       z                                               ",
            "     zzzzzzzzzzz zzzzzzzz                       z                                               ",
            "     z                  z                       z                                               ",
            "     z                  ]                       z                                               ",
            "     zzzz]zzzzz]zzzzz]zzz                       z                                               ",
            "      z     z     z     z                       z                                               ",
            "      z     z     z     zzzzzzzzzzzzzzzzzzzzzzzzz                                               ",
            "      z     z     z     z                                                                       ",
            "      z     z     z     z                                                                       ",
            "      zzzzzzzzzzzzzzzzzzz                                                                       ",
            "                                                                                                ",
            "                                                                                                ",
            "                                                                                                ",
            "                                                                                                ",
            "                                                                                                ",
            "                                                                                                ",
            "                                                                                                ",
            "                                                                                                "
            ],
        "terrain": {
            "N": "t_wall_bulkhead",
            "L": "t_wall_metal",
            "l": "t_strconc_wall_w",
            "W": "t_brick_wall",
            "z": "t_strconc_wall_r",
            "T": "t_door_metal_bulkhead_c",
            "t": "t_door_gray_c",
            "]": "t_door_lab_c",
            "[": "t_door_metal_lab_c",
            "G": "t_ballistic_glass",
            "^": "t_stairs_up",
            " ": "t_floor",
            "/": "t_linoleum_whitefloor_olight",
            ",": "t_linoleum_whitefloor_olight",
            "`": "t_pavement",
            ".": "t_concrete",
            "!": "t_concrete"
                },
                "furniture": { 
			"q": "f_locker",
			"h": "f_desk",
			"n": "f_chair_black",
      "A": "f_armchair",
      "B": "f_bookcase",
      "v": "f_filing_cabinet",
			"S": "f_sofa",
			"f": "f_table",
      "+":  "f_dresser",
			"b": "f_bed",
			"r": "f_rack",
      ",": "f_toilet"
	}
     }
    }
]