[
    {
       "type": "mapgen",
       "method": "json",
       "om_terrain": [ "lc_surface" ],
       "weight": "500",
       "object": {
         "fill_ter": "t_concrete",
         "rows": [
            "   NNNNNNNNNNNNN        ",
            "   NNNNNNNNNNNNN        ",
            "   NNNN     NNNN        ",
            "   NNNN     NNNN        ",
            "   NNNN     NNNN        ",
            "   NNNN     NNNN        ",
            "   NNNN     NNNN        ",
            "   NNNN                 ",
            "   NNNNNNNNNNNNN        ",
            "                        ",
            "                        ",
            "                        ",
            "                        ",
            "                        ",
            "                        ",
            "                        ",
            "                        ",
            "                        ",
            "                        ",
            "                        ",
            "                        ",
            "                        ",
            "                        ",
            "                        "
            ],
            "terrain": {
                "N": "t_wall_bulkhead",
                "O": "t_window_enhanced_noglass",
                "T": "t_door_metal_c_peep",
                "#": "t_door_bar_c",
                "_": "t_sidewalk",
                " ": [ [ "t_grass", 15], [ "t_dirt",1], [ "t_grass_dead", 3],["t_tree_apple", 3] ],
                "/": "t_linoleum_whitefloor_olight",
                "`": "t_linoleum_white",
                ".": "t_linoleum_gray",
                "!": "t_floor_olight"
                    },