[
    {
       "type": "mapgen",
       "method": "json",
       "om_terrain": [ "lc_surface" ],
       "weight": "500",
       "object": {
         "fill_ter": "t_concrete",
         "rows": [
            "   NNNNNNNNNNNNN        ",
            "   NNNNNNNNNNNNN        ",
            "   NNNNNNNNNNNNN        ",
            "   NNNNN_N_NNNNN!!!     ",
            "   NNNN.....NNNNN!!     ",
            "   NNNNNNTNNNNNNNN!!!!!!",
            "   NNNN.....NNNNNNN`````",
            "   NNNN.N.N.T#T#T#T`````",
            "   NNNNNNNNNNNNNNNN`````",
            "   NNNNNNNNNNNNNNN!```!!",
            "   NNNNNNNNNNNNNN!!```  ",
            "   NNNNNNNNNNNNN!!!```  ",
            "                   ```  ",
            "     !!!           ```  ",
            "     !````````````````  ",
            "     !````````````````! ",
            "     !````````````````! ",
            "     !!!            !!! ",
            "                        ",
            "                        ",
            "                        ",
            "                        ",
            "                        ",
            "                        "
            ],
            "terrain": {
                "N": "t_wall_bulkhead",
                "O": "t_window_enhanced_noglass",
                "T": "t_door_metal_bulkhead_c",
                "#": "t_door_bar_c",
                "_": "t_stairs_down",
                " ": "t_metal_floor_no_roof",
                "/": "t_linoleum_whitefloor_olight",
                "`": "t_pavement",
                ".": "t_concrete",
                "!": "t_concrete"
                    }
       }
    },
    {
        "type": "mapgen",
        "method": "json",
        "om_terrain": [ "lc_mid" ],
        "weight": "500",
        "object": {
          "fill_ter": "t_concrete",
          "rows": [
            "                        ",
            "         NNN            ",
            "         N_N            ",
            "        NNTNN           ",
            "        N...N           ",
            "        N...N           ",
            "        N...N           ",
            "        NNTNN           ",
            "         N#N            ",
            "         NNN            ",
            "                        ",
            "                        ",
            "                        ",
            "                        ",
            "                        ",
            "                        ",
            "                        ",
            "                        ",
            "                        ",
            "                        ",
            "                        ",
            "                        ",
            "                        ",
            "                        "
            ],
             "terrain": {
                 "N": "t_wall_bulkhead",
                 "O": "t_window_enhanced_noglass",
                 "T": "t_door_metal_bulkhead_c",
                 "#": "t_stairs_down",
                 "_": "t_stairs_up",
                 " ": "t_soil",
                 "/": "t_linoleum_whitefloor_olight",
                 "`": "t_pavement",
                 ".": "t_concrete",
                 "!": "t_concrete"
                     }
        }
     },
     {
        "type": "mapgen",
        "method": "json",
        "om_terrain": [ ["lc_lab_lt", "lc_lab_mt2", "lc_lab_mt1", "lc_lab_rt" ],
                        ["lc_lab_lb", "lc_lab_mb2", "lc_lab_mb1", "lc_lab_rb" ] ],
        "weight": "500",
        "object": {
          "fill_ter": "t_concrete",
          "rows": [
            "        WWWWWWWWWWWWWWWWWWW               NNNNNNNN                    llllllllllllllllllll      ",
            "        WBBBvvvWhv hvhhvhhW         NNNNNNN..NN.^NNNNNNN              lB    v v v v     Bl      ",
            "        W      Wn  n  n  nW         NqqqqqN.....^NqqqqqN              lB    v v v v     Bl      ",
            "        WAh    t         nWWWWWWWWWWN     NNN//NNN     Nllllllllllllllll&              &ll      ",
            "        W h    W   nh  vhhW         T     T......T     T           [   l&&&&        &&&&l       ",
            "    WWWWWWWWWWWWWGGGGGtGGWW   NNNNNNNNNTNNNNNNNNNNNNTNNNNNNNNNNNNNNN   llllllllll[llllllll      ",
            "    Wq/t                      N  ii        ii   ii N   N     Nbb bbN                l  hAl      ",
            "    WWWWWWWWWWtWWWWWWWWWWWW   N iffi      iffi iffiN   T           N                [  hvlll    ",
            "           W     WBBBAhA vW   N  ii        ii   ii N   Nhhh        Nllllllllllll    l     vl    ",
            "           W v v W        t   N  ii                N   NoA   Nbb bbN           l    lB    Bl    ",
            "           W v v WS      AW   N iffi       ||||||||NTNNNNNNNNNNNNNNN           l    looooool    ",
            "           W v v WS      hG   N  ii        |      FN               N         lll    llllllllllll",
            "           WvvvvvWSSS    AW   N  ii        |  ~ ~ *N               N         l           lo   ol",
            "WWWWWWWWWWWWWWWWWWWWWWGGGWW   N iffi       |  ~ ~ *N               N         l           lo   ol",
            "WhbbWhbbWhbbWhbbWhbbW         N  ii        |      FN               N         l           l     l",
            "Wn +Wn +Wn +Wn +Wn +W   W    WNNNNNNNNNTNNNNNNNNNNNN               N         l           l     l",
            "W   W   W   W   W   W   WffffW  ,W,  N    G        N               N         lllllllll[llllll[ll",
            "WWtWWWtWWWtWWWtWWWtWW   WWWWWW  sWs  N    G        NNNNNNNNNNNNNNNNN            lv            vl",
            "W                       W    WtWWWWWtN    G                        N            lGGGG      GGGGl",
            "W                            W       N    T                        N            l   Gh    hG   l",
            "WWtWWWtWWWtWWWtWWWtWW        WWWW WWWN    G                        N            l J Ghn  nhG J l",
            "W   W   W   W   W   WWWWW    t       N    G                        N            l   Gh    hG   l",
            "W+ nW+ nW+ nW+ nW+ nW   W    Wssssss@N    G                        N            lGGGG      GGGGl",
            "WbbhWbbhWbbhWbbhWbbhW   WWWWWWWWWWWWWNTTNNNNNNNNNNNNNNNNNNNNNNNNNNNN            l              l",
            "WWWWWWWWWWWWWWWWWWWWW                z  z                                       lB &&&&  &&&& Bl",
            "                                     z  z                                       lB            Bl",
            "          zzzzzzzzzzzzzzz            z  z                                       lB %  %  %  % Bl",
            "          z     A      Bz            z  z                                       lB %%%%  %%%% Bl",
            "          z    hhh     Bzzzzzzzzzzzzzzttzzzzzzzzz                               llllllllllllllll",
            "          z          zzzz                       z                                               ",
            "          z    z[zvvvz  z                       z                                               ",
            "     zzzzzzzzzzz zzzzzzzz hhh                   z                                               ",
            "     z                  ]  Ah                   z                                               ",
            "     z                  ]   h                   z                                               ",
            "     zzzz]zzzzz]zzzzz]zzz hhh                   z                                               ",
            "      z     z     z     z                       z                                               ",
            "      zB   hzB    zB    zzzzzzzzzzzzzzzzzzzzzzzzz                                               ",
            "      zB  AhzB hhhzB hhhz                                                                       ",
            "      zB   hzB  A zB  A z                                                                       ",
            "      zzzzzzzzzzzzzzzzzzz                                                                       ",
            "                                                                                                ",
            "                                                                                                ",
            "                                                                                                ",
            "                                                                                                ",
            "                                                                                                ",
            "                                                                                                ",
            "                                                                                                ",
            "                                                                                                "
            ],
        "terrain": {
            "N": "t_wall_bulkhead",
            "L": "t_wall_metal",
            "l": "t_strconc_wall_w",
            "W": "t_brick_wall",
            "z": "t_strconc_wall_r",
            "T": "t_door_metal_bulkhead_c",
            "t": "t_door_gray_c",
            "]": "t_door_lab_c",
            "[": "t_door_metal_lab_c",
            "G": "t_ballistic_glass",
            "^": "t_stairs_up",
            " ": "t_floor",
            "/": "t_linoleum_whitefloor_olight",
            ",": "t_linoleum_whitefloor_olight",
            "`": "t_pavement",
            ".": "t_concrete"
                },
                "furniture": { 
			"q": "f_locker",
			"h": "f_desk",
			"n": "f_chair_black",
      "i": "f_chair",
      "A": "f_armchair",
      "B": "f_bookcase",
      "v": "f_filing_cabinet",
			"S": "f_sofa",
			"f": "f_table",
      "+":  "f_dresser",
			"b": "f_bed",
			"r": "f_rack",
      ",": "f_toilet",
      "s":"f_sink",
      "@": "f_metal_trashcan",
      "o": "f_glass_cabinet",
      "!": "f_bulletin",
      "|": "f_counter",
      "&": "f_lab_bench",
      "~": "f_cupboard",
      "*": "f_oven",
		  "F": "f_fridge",
      "%": "f_workbench",
      "J": "f_slab"
	}
     }
    }
]