[
    {
       "type": "mapgen",
       "method": "json",
       "om_terrain": [ "lc_surface" ],
       "weight": "500",
       "object": {
         "fill_ter": "t_concrete",
         "rows": [
            "   NNNNNNNNNNNNN        ",
            "   NNNNNNNNNNNNN        ",
            "   NNNNNNNNNNNNN        ",
            "   NNNNN_N_NNNNN!!!     ",
            "   NNNN.....NNNNN!!     ",
            "   NNNNNNTNNNNNNNN!!!!!!",
            "   NNNN.....NNNNNNN`````",
            "   NNNN.N.N.T#T#T#T`````",
            "   NNNNNNNNNNNNNNNN`````",
            "   NNNNNNNNNNNNNNN!```!!",
            "   NNNNNNNNNNNNNN!!```  ",
            "   NNNNNNNNNNNNN!!!```  ",
            "                   ```  ",
            "     !!!           ```  ",
            "     !````````````````  ",
            "     !````````````````! ",
            "     !````````````````! ",
            "     !!!            !!! ",
            "                        ",
            "                        ",
            "                        ",
            "                        ",
            "                        ",
            "                        "
            ],
            "terrain": {
                "N": "t_wall_bulkhead",
                "O": "t_window_enhanced_noglass",
                "T": "t_door_metal_bulkhead_c",
                "#": "t_door_bar_c",
                "_": "t_stairs_down",
                " ": "t_metal_floor_no_roof",
                "/": "t_linoleum_whitefloor_olight",
                "`": "t_pavement",
                ".": "t_concrete",
                "!": "t_concrete"
                    }
       }
    },
    {
        "type": "mapgen",
        "method": "json",
        "om_terrain": [ "lc_mid" ],
        "weight": "500",
        "object": {
          "fill_ter": "t_concrete",
          "rows": [
            "                        ",
            "         NNN            ",
            "         N_N            ",
            "        NNTNN           ",
            "        N...N           ",
            "        N...N           ",
            "        N...N           ",
            "        NNTNN           ",
            "         N#N            ",
            "         NNN            ",
            "                        ",
            "                        ",
            "                        ",
            "                        ",
            "                        ",
            "                        ",
            "                        ",
            "                        ",
            "                        ",
            "                        ",
            "                        ",
            "                        ",
            "                        ",
            "                        "
            ],
             "terrain": {
                 "N": "t_wall_bulkhead",
                 "O": "t_window_enhanced_noglass",
                 "T": "t_door_metal_bulkhead_c",
                 "#": "t_stairs_down",
                 "_": "t_stairs_up",
                 " ": "t_soil",
                 "/": "t_linoleum_whitefloor_olight",
                 "`": "t_pavement",
                 ".": "t_concrete",
                 "!": "t_concrete"
                     }
        }
     },
     {
        "type": "mapgen",
        "method": "json",
        "om_terrain": [ ["lc_lab_lt", "lc_lab_mt2", "lc_lab_mt1", "lc_lab_rt" ],
                        ["lc_lab_lb", "lc_lab_mb2", "lc_lab_mb1", "lc_lab_rb" ] ],
        "weight": "500",
        "object": {
          "fill_ter": "t_concrete",
          "rows": [
            "        WWWWWWWWWWWWWWWWWWW               NNNNNNNN                    llllllllllllllllllll      ",
            "        WBBBvvvWhv`hvhhvhhW         NNNNNNN..NN.^NNNNNNN              lB....v.v.v.v.....Bl      ",
            "        W``````Wn``n``n``nW         NqqqqqN.....^NqqqqqN              lB....v.v.v.v.....Bl      ",
            "        WAh``/`t`````/```nWWWWWWWWWWN`````NNN//NNN,,,,,Nllllllllllllllll&000...1....000&ll      ",
            "        W`h````W```nh``vhhW`````````T/````T......T,,,,=T,,,,,,,,,,=[,,,l&&&&........&&&&l       ",
            "    WWWWWWWWWWWWWGGGGGtGGWW```NNNNNNNNNTNNNNNNNNNNNNTNNNNNNNNNNNNNNN,,,llllllllll[llllllll      ",
            "    Wq/t``````````````````````N``ii````````ii```ii`N,,,N,,,,,Nbb,bbN,,,,,,,,,,,,,=,,l,,hAl      ",
            "    WWWWWWWWWWtWWWWWWWWWWWW```N`iffi```/``iffi/iffiN,,,T,,,,,=,,,,,N,,,,,,,,,,,,,,,,[,,hvlll    ",
            "           W.....WBBBAhA5vW```N``ii````````ii```ii`N,=,Nhh,,,=,,,,,Nllllllllllll,,,,l,,,,,vl    ",
            "           W.v.v.W55555555t```N``ii````````````````N,,,NoA,,,Nbb,bbN           l,,,,lB,,,,Bl    ",
            "           W.v.v.WS555655AW```N`iffi```````||||||||NNNNNNNNNNNNNNNNN           l,,,,looooool    ",
            "           W.v1v.WS555555hG```N``ii````````|......FN               N         lll,,,,lllllNNNNNNN",
            "           WvvvvvWSSS5555AW```N``ii````/```|..~.~.*N               N         lB,,,,,,,,,@No000oN",
            "WWWWWWWWWWWWWWWWWWWWWWGGGWW```N`iffi```````|..~.~.*N               N         lS,,,,=,,,,,No0.0oN",
            "WhbbWhbbWhbbWhbbWhbbW`````````N``ii````````|......FN               N         lS,,,,,,,,,,N.....N",
            "Wn3+Wn3+Wn3+Wn3+Wn3+W```W````WNNNNNNNNNTNNNNNNNNNNNN               N         lB,,,,,,,,,,N.....N",
            "W343W343W343W343W343W```Wfff@W..2W2..N....G......hAN               N         lllllllll[llNNNN[NN",
            "WWtWWWtWWWtWWWtWWWtWW```WWWWWW.1sWs1.N....G......h.NNNNNNNNNNNNNNNNN            lv............vl",
            "W```````````````````````W````WtWWWWWtN....G........NbqbqbqbqbqbqbqbN            lGGGG1.....GGGGl",
            "W````````````````````````````W.......N..1.T........Nb.b.b.b.b.b.b.bN            l000Gh....hG000l",
            "WWtWWWtWWWtWWWtWWWtWW````````WWWW1WWWN....G........N...............N            l0J0Ghn..nhG0J0l",
            "W343W343W343W343W343WWWWW````t.......N....G........N.......1.......N            l000Gh....hG000l",
            "W+3nW+3nW+3nW+3nW+3nW   W````Wssssss@N....G.....1..T...............N            lGGGG1....1GGGGl",
            "WbbhWbbhWbbhWbbhWbbhW   WWWWWWWWWWWWWNTTNNNNNNNNNNNNNNNNNNNNNNNNNNNN            l..............l",
            "WWWWWWWWWWWWWWWWWWWWW                z55z                                       lB.&&&&..&&&&.Bl",
            "                                     z55z                                       lB.1........1.Bl",
            "          zzzzzzzzzzzzzzz            z55z                                       lB.%..%..%..%.Bl",
            "          zo5555A555555Bz            z56z                                       lB.%%%%..%%%%.Bl",
            "          zo5555hh55555Bzzzzzzzzzzzzzzttzzzzzzzzz                               llllllllllllllll",
            "          z5555565555zzzz............5555.......z                                               ",
            "          zvvvvz[zvvvz  z5555555.....5555.......z                                               ",
            "     zzzzzzzzzzz.zzzzzzzz5hhh555555565555.......z                                               ",
            "     z,`,`,`,`,`=`,`,`,`]5.Ah655555555555.......z                                               ",
            "     z`,`,`,`,`,`,`,`,`,]5..h555555555555.......z                                               ",
            "     zzzz]zzzzz]zzzzz]zzz5hhh555555565555.......z                                               ",
            "      z33333z33333z33333z5555555................z                                               ",
            "      zB3439zB3433zB3433zzzzzzzzzzzzzzzzzzzzzzzzz                                               ",
            "      zB33A9zB33hhzB33hhz                                                                       ",
            "      zB3339zB33A3zB33A3z                                                                       ",
            "      zzzzzzzzzzzzzzzzzzz                                                                       ",
            "                                                                                                ",
            "                                                                                                ",
            "                                                                                                ",
            "                                                                                                ",
            "                                                                                                ",
            "                                                                                                ",
            "                                                                                                ",
            "                                                                                                "
            ],
            "place_npcs": [
          { "class": "alpha_npc", "x": 10, "y": 37 },
          { "class": "white_npc", "x": 16, "y": 27 },
          { "class": "akihiro_npc", "x": 88, "y": 6 },
          { "class": "lc_sci_npc", "x": 74, "y": 3 },
          { "class": "lc_sci_npc", "x": 78, "y": 13 },
          { "class": "lc_sci_npc", "x": 86, "y": 20 },
          { "class": "lc_sci_npc", "x": 92, "y": 13 },
          { "class": "lc_doc_npc", "x": 57, "y": 9 },
          { "class": "isao_npc", "x": 50, "y": 16 },
          { "class": "lc_guard_npc", "x": 52, "y": 18 },
          { "class": "lc_guard_npc", "x": 61, "y": 19 },
          { "class": "lc_guard_npc", "x": 65, "y": 6 },
          { "class": "lc_rec_npc", "x": 27, "y": 32 },
          { "class": "zonya_npc", "x": 9, "y": 3 },
          { "class": "lc_clerk_npc", "x": 14, "y": 11 },
          { "class": "lc_clerk_npc", "x": 35, "y": 13 },
          { "class": "lc_clerk_npc", "x": 25, "y": 3 },
          { "class": "lc_clerk_npc", "x": 25, "y": 12 },
          { "class": "bongbong_npc", "x": 16, "y": 38 },
          { "class": "lc_cook_npc", "x": 44, "y": 12 }
          ],
        "terrain": {
            "N": "t_wall_bulkhead",
            "L": "t_wall_metal",
            "l": "t_strconc_wall_w",
            "W": "t_brick_wall",
            "z": "t_strconc_wall_r",
            "T": "t_door_metal_bulkhead_c",
            "t": "t_door_gray_c",
            "]": "t_door_lab_c",
            "[": "t_door_metal_lab_c",
            "G": "t_ballistic_glass",
            "^": "t_stairs_up",
            " ": "t_rock",
            "/": "t_linoleum_whitefloor_olight",
            ",": "t_linoleum_gray",
            "=": "t_linoleum_gray_floor_olight",
            "`": "t_linoleum_white",
            ".": "t_concrete",
            "0": "t_grate",
            "1": "t_strconc_floor_olight",
            "3": "t_floor",
            "4": "t_floor_olight",
            "5": "t_carpet_metal_red",
            "6": "t_carpet_red_light"
                },
                "furniture": { 
			"q": "f_locker",
			"h": "f_desk",
			"n": "f_chair_black",
      "i": "f_chair",
      "A": "f_armchair",
      "B": "f_bookcase",
      "v": "f_filing_cabinet",
			"S": "f_sofa",
			"f": "f_table",
      "+":  "f_dresser",
			"b": "f_bed",
			"r": "f_rack",
      "2": "f_toilet",
      "s":"f_sink",
      "@": "f_metal_trashcan",
      "o": "f_glass_cabinet",
      "!": "f_bulletin",
      "|": "f_counter",
      "&": "f_lab_bench",
      "~": "f_cupboard",
      "*": "f_oven",
		  "F": "f_fridge",
      "%": "f_workbench",
      "J": "f_slab",
      "9": "f_console"
	}
     }
    }
]