[
    {
       "type": "mapgen",
       "method": "json",
       "om_terrain": [ "lc_surface" ],
       "weight": "500",
       "object": {
         "fill_ter": "t_concrete",
         "rows": [
            "   NNNNNNNNNNNNN        ",
            "   NNNNNNNNNNNNN        ",
            "   NNNN.....NNNN        ",
            "   NNNN.....NNNN        ",
            "   NNNN.....NNNNN       ",
            "   NNNN.....NNNNNN      ",
            "   NNNN.....NNNNNNN     ",
            "   NNNN.....T#T#T#T     ",
            "   NNNNNNNNNNNNNNNN     ",
            "   NNNNNNNNNNNNNNN      ",
            "   NNNNNNNNNNNNNN       ",
            "   NNNNNNNNNNNNN        ",
            "                        ",
            "                        ",
            "                        ",
            "                        ",
            "                        ",
            "                        ",
            "                        ",
            "                        ",
            "                        ",
            "                        ",
            "                        ",
            "                        "
            ],
            "terrain": {
                "N": "t_wall_bulkhead",
                "O": "t_window_enhanced_noglass",
                "T": "t_door_metal_bulkhead_c",
                "#": "t_door_bar_c",
                "_": "t_sidewalk",
                " ": [ [ "t_grass", 15], [ "t_dirt",1], [ "t_grass_dead", 3],[ "t_tree_hickory_dead", 6] ],
                "/": "t_linoleum_whitefloor_olight",
                "`": "t_linoleum_white",
                ".": "t_concrete",
                "!": "t_floor_olight"
                    },