[
    {
       "type": "mapgen",
       "method": "json",
       "om_terrain": [ "lc_surface" ],
       "weight": "500",
       "object": {
         "fill_ter": "t_concrete",
         "rows": [
            "   NNNNNNNNNNNNN        ",
            "   NNNNNNNNNNNNN        ",
            "   NNNNNNNNNNNNN        ",
            "   NNNNN_N_NNNNN!!!     ",
            "   NNNN.....NNNNN!!     ",
            "   NNNNNNTNNNNNNNN!!!!!!",
            "   NNNN.....NNNNNNN`````",
            "   NNNN.N.N.T#T#T#T`````",
            "   NNNNNNNNNNNNNNNN`````",
            "   NNNNNNNNNNNNNNN!```!!",
            "   NNNNNNNNNNNNNN!!```  ",
            "   NNNNNNNNNNNNN!!!```  ",
            "                   ```  ",
            "     !!!           ```  ",
            "     !````````````````  ",
            "     !````````````````! ",
            "     !````````````````! ",
            "     !!!            !!! ",
            "                        ",
            "                        ",
            "                        ",
            "                        ",
            "                        ",
            "                        "
            ],
            "terrain": {
                "N": "t_wall_bulkhead",
                "O": "t_window_enhanced_noglass",
                "T": "t_door_metal_bulkhead_c",
                "#": "t_door_bar_c",
                "_": "t_stairs_down",
                " ": "t_metal_floor_no_roof",
                "/": "t_linoleum_whitefloor_olight",
                "`": "t_pavement",
                ".": "t_concrete",
                "!": "t_concrete"
                    }
       }
    },
    {
        "type": "mapgen",
        "method": "json",
        "om_terrain": [ "lc_mid" ],
        "weight": "500",
        "object": {
          "fill_ter": "t_concrete",
          "rows": [
            "                        ",
            "         NNN            ",
            "         N_N            ",
            "        NNTNN           ",
            "        N...N           ",
            "        N...N           ",
            "        N...N           ",
            "        NNTNN           ",
            "         N#N            ",
            "         NNN            ",
            "                        ",
            "                        ",
            "                        ",
            "                        ",
            "                        ",
            "                        ",
            "                        ",
            "                        ",
            "                        ",
            "                        ",
            "                        ",
            "                        ",
            "                        ",
            "                        "
            ],
             "terrain": {
                 "N": "t_wall_bulkhead",
                 "O": "t_window_enhanced_noglass",
                 "T": "t_door_metal_bulkhead_c",
                 "#": "t_stairs_down",
                 "_": "t_stairs_up",
                 " ": "t_soil",
                 "/": "t_linoleum_whitefloor_olight",
                 "`": "t_pavement",
                 ".": "t_concrete",
                 "!": "t_concrete"
                     }
        }
     },
     {
        "type": "mapgen",
        "method": "json",
        "om_terrain": [ ["lc_lab_lt", "lc_lab_mt2", "lc_lab_mt1", "lc_lab_rt" ],
                        ["lc_lab_lb", "lc_lab_mb2", "lc_lab_mb1", "lc_lab_rb" ] ],
        "weight": "500",
        "object": {
          "fill_ter": "t_concrete",
          "rows": [
            "        WWWWWWWWWWWWWWWWWWW               NNNNNNNN                                              ",
            "        W      W          W         NNNNNNN  NN ^NNNNNNN                                        ",
            "        W      W          W         N     N     ^N     N                                        ",
            "        W      t          WWWWWWWWWWN     NNN  NNN     N                                        ",
            "        W      W          W         T     T      T     T                                        ",
            "    WWWWWWWWWWWWWGGGGGtGGWW   NNNNNNNNNTNNNNNNNNNNNNTNNNNNNNNNNNNNNN                            ",
            "    W  t                      N                    N   N           N                            ",
            "    WWWWWWWWWWtWWWWWWWWWWWW   N                    N   T           N                            ",
            "           W     W        W   N                    N   N           N                            ",
            "           W     W        t   N                    N   N           N                            ",
            "           W     W        W   N                    NTNNNNNNNNNNNNNNN                            ",
            "           W     W        G   N                    N               N                            ",
            "           W     W        W   N                    N               N                            ",
            "WWWWWWWWWWWWWWWWWWWWWWGGGWW   N                    N               N                            ",
            "W   W   W   W   W   W         N                    N               N                            ",
            "W   W   W   W   W   W   W    WNNNNNNNNNTNNNNNNNNNNNNNNNNNNNNNNNNNNNN                            ",
            "W   W   W   W   W   W   W    W       W                                                          ",
            "WWtWWWtWWWtWWWtWWWtWW   WWWWWW       W                                                          ",
            "W                            W       W                                                          ",
            "W                            W       W                                                          ",
            "WWtWWWtWWWtWWWtWWWtWW        W       W                                                          ",
            "W   W   W   W   W   WWWWW    t       W                                                          ",
            "W   W   W   W   W   W   W    W       W                                                          ",
            "W   W   W   W   W   W   WWWWWWWWWWWWWW                                                          ",
            "WWWWWWWWWWWWWWWWWWWWW                                                                           ",
            "                                                                                                ",
            "                                                                                                ",
            "                                                                                                ",
            "                                                                                                ",
            "                                                                                                ",
            "                                                                                                ",
            "                                                                                                ",
            "                                                                                                ",
            "                                                                                                ",
            "                                                                                                ",
            "                                                                                                ",
            "                                                                                                ",
            "                                                                                                ",
            "                                                                                                ",
            "                                                                                                ",
            "                                                                                                ",
            "                                                                                                ",
            "                                                                                                ",
            "                                                                                                ",
            "                                                                                                ",
            "                                                                                                ",
            "                                                                                                ",
            "                                                                                                "
            ],
        "terrain": {
            "N": "t_wall_bulkhead",
            "L": "t_wall_metal",
            "l": "t_strconc_wall_w",
            "W": "t_brick_wall",
            "T": "t_door_metal_bulkhead_c",
            "t": "t_door_gray_c",
            "[": "t_door_metal_lab_c",
            "G": "t_ballistic_glass",
            "^": "t_stairs_up",
            " ": "t_floor",
            "/": "t_linoleum_whitefloor_olight",
            "`": "t_pavement",
            ".": "t_concrete",
            "!": "t_concrete"
                }
     }
    }
]