[
{
    "type": "mapgen",
    "method": "json",
    "om_terrain": [ "kr_hideout" ],
    "object": {
      "fill_ter": "t_floor",
      "rows": [
			"   *            *       ",
            "          *      *      ",
            "  NNNNNNNNNNNNNNNNNNN   ",
            " *N~~~ff~...N.AtA...O   ",
            "  OX````~...N.....nKO   ",
            "  OX`((`~...D..!.7nhO   ",
            "  N(````~...N.....n.O * ",
            "  N~~~~,~...NNNNNNNNN   ",
            "  N.cc...c..........N   ",
            "  NcTTc.cTc.........O  *",
            "* NcTTc.cTc.....!...O   ",
            "  N.cc...c..........N   ",
            "  NNNN_NNN...NN.BB.NN   ",
            "*  *NH!......N......O   ",
            "*   NH..........SS..O   ",
            "  NNNNNNNN...N!SttS!N   ",
            "  Nooo..D....N.SttS.N   ",
            "  N....qNNNDNNOONNOON   ",
            "  NZZ!.qNF.!.$....At/   ",
            "  NZZ..?NF.||N....../   ",
            "* NNNNNNNNNOON...////   ",
            " *            www       ",
            "  * *      *  www * *   ",
            "       * *    www       "
			],
			"palettes": [ "zwei_palette" ],
			"items": {
	"T": { "item": "table_foyer", "chance": 35 },
	"t": { "item": "drug_table", "chance": 75 }
			},
			"place_npcs": [
        { "class": "sayo_npc", "x": 19, "y": 5 },
		{ "class": "yang_npc", "x": 14, "y": 3 },
		{ "class": "gin_npc", "x": 16, "y": 3 },
		{ "class": "kr_cook_npc", "x": 4, "y": 4 },
		{ "class": "kr_npc", "x": 16, "y": 14 },
		{ "class": "kr_npc", "x": 15, "y": 15 },
		{ "class": "kr_npc", "x": 19, "y": 9 },
		{ "class": "kr_npc", "x": 6, "y": 10 },
		{ "class": "kr_npc", "x": 15, "y": 18 }
		],
			"terrain": {
		"N": "t_brick_wall",
		"l": "t_strconc_wall_cyan",
		"O": "t_reinforced_glass_shutter_open",
		".": "t_floor",
		"`": "t_linoleum_white",
		",": "t_linoleum_gray_floor_olight",
		"$": "t_door_metal_c_peep",
		" ": [ [ "t_grass", 15], [ "t_dirt",1], [ "t_grass_dead", 3] ],
		"w": "t_sidewalk",
		"/": "t_splitrail_fence",
		"J": "t_door_bar_c",
		"*": [ ["t_tree", 10] , ["t_tree_apple", 8], ["t_tree_peach", 5], ["t_tree_cherry", 7] ],
		"^": "t_stairs_up",
				"D": "t_door_c",
				"!": "t_floor_olight"
			},
		"furniture": { 
		"n": "f_desk",
		"h": "f_chair_black",
		"H": "f_chair_white",
		"c": "f_chair",
		"S": "f_sofa",
		"T": "f_table",
		"t": "f_coffee_table",
		"B": "f_bookcase",
		"q": "f_sink",
		"o": "f_glass_cabinet",
		"F": "f_wardrobe",
		"_": "f_curtain",
		"|": "f_rack_coat",
		"b": "f_rack",
		"~": "f_counter",
		"(": "f_cupboard",
		"+":  "f_counter_gate_c",
		"A": "f_armchair",
		"7": "f_chair_plywood",
		"?": "f_toilet",
		" ": [ ["f_flower_tulip", 13], ["f_black_eyed_susan",5], [ "f_bluebell", 8], [ "f_null", 200] ],
		"j": "f_bench_park",
		"Z": "f_bathtub",
		"X": "f_oven",
		"f": "f_fridge",
		"K": "f_safe_l"
		
		}
	}
},
{
    "type": "mapgen",
    "method": "json",
    "om_terrain": [ "kr_hideout_roof" ],
    "object": {
      "fill_ter": "t_flat_roof",
      "rows": [
			"                        ",
            "                        ",
            "  ...................   ",
            "  ...................   ",
            "  ...................   ",
            "  ...................   ",
            "  ...................   ",
            "  ...................   ",
            "  ...................   ",
            "  ...................   ",
            "  ...................   ",
            "  ...................   ",
            "  ...................   ",
            "    .................   ",
            "    .................   ",
            "  ...................   ",
            "  ...................   ",
            "  ...................   ",
            "  ...................   ",
            "  ...................   ",
            "  ...................   ",
            "                        ",
            "                        ",
            "                        "
	  ],
	  "palettes": [ "roof_palette" ]
	}
}
]