[
{
"type": "mapgen",
"method": "json",
"om_terrain": [ "zwei_office0"] ,
"weight": "2000",
"object": {
	"fill_ter": "t_linoleum_white",
	"rows": [
	"lNNNNNJJNNNNNNNNNNNNNNNN",
	"lwwwwwww_*___*___*____*N",
	"lwwwwwwwwwwwwwwwwww__*_N",
	"llXXllOOlllllllOOlw____N",
	"l@``@l..lvnlnvl..lw**__N",
	"lS``Sl../hnlnh/..lw____N",
	"lS``Sl..lllllll..Ow*_*_N",
	"l,``,l..lvnlnvl..Ow_**_N",
	"lnn``l../hnlnh/..lw____N",
	"``H```..lllllll..lw__*_N",
	"llllll.....,.....lw_*_*N",
	".................lwwww_N",
	".l/lll/l...l```llllllNNN",
	".lhvlvhl...`````BBSSlw_N",
	".lnnlnnl.,.``````/tSlw_N",
	".lllllll...`````BBSSlw_N",
	".lnnlnnl...l````lllllw_N",
	".lhvlvhl...lcc``lFFqlw_N",
	".l/lll/l...lTTc/+``~lw_N",
	"...........lcc``lboqlw*N",
	"lllllllllXlllllllllllw_N",
	"wwwwwwwwwwwwwwwwwwwwww_N",
	"wwwwwwwwwww_*____*__*__N",
	"NJJJNNNN___*_*_*___NNNNN"
	],
	"palettes": [ "zwei_palette" ],
  "faction_owner": [ { "id": "zwei_association", "x": [ 0, 23 ], "y": [ 0, 23 ] } ],
	"place_npcs": [
        { "class": "zwei_rec_npc", "x": 2, "y": 9 },
		{ "class": "zwei_food_npc", "x": 17, "y": 18 },
		{ "class": "zwei_office1_npc", "x": 2, "y": 13 },
		{ "class": "zwei_office3_npc", "x": 12, "y": 17 },
		{ "class": "zwei_office2_npc", "x": 13, "y": 8 }
		],
	"terrain": {
		"N": "t_brick_wall",
		"l": "t_strconc_wall_cyan",
		"O": "t_reinforced_glass_shutter_open",
		".": "t_linoleum_gray",
		"`": "t_linoleum_white",
		",": "t_linoleum_gray_floor_olight",
		"X": "t_door_metal_c_peep",
		"_": [ [ "t_grass", 15], [ "t_dirt",1], [ "t_grass_dead", 3] ],
		"w": "t_sidewalk",
		"/": "t_linoleum_whitefloor_olight",
		"J": "t_door_bar_c",
		"*": [ ["t_tree", 10] , ["t_tree_apple", 8], ["t_tree_peach", 5], ["t_tree_cherry", 7] ]
	},
	"furniture": { 
		"n": "f_desk",
		"h": "f_chair_black",
		"H": "f_chair_white",
		"c": "f_chair",
		"S": "f_sofa",
		"T": "f_table",
		"t": "f_coffee_table",
		"B": "f_bookcase",
		"+": "f_counter_gate_c",
		"q": "f_counter",
		"o": "f_oven",
		"F": "f_fridge",
		"b": "f_rack",
		"~": "f_cupboard",
		"A": "f_armchair",
		"@": "f_metal_trashcan",
		"v": "f_filing_cabinet"
},
"items": {
        "n": { "item": "SUS_office_desk", "chance": 75 },
        "v": { "item": "SUS_office_filing_cabinet", "chance": 80 },
        "R": { "item": "office_supplies", "chance": 80, "repeat": [ 1, 2 ] },
        "@": { "item": "trash", "chance": 60, "repeat": [ 1, 2 ] },
        "B": { "item": "novels", "chance": 80, "repeat": [ 4, 8 ] }
      }
}
},
{
"type": "mapgen",
"method": "json",
"om_terrain": [ "zwei_office1"] ,
"weight": "2000",
"object": {
	"fill_ter": "t_linoleum_white",
	 "rows": [
            "NNNNNNNNNNNNllGGGllGGGll",
            "N__+__+__+__l.....,.....",
            "N_wwwwwwwwwwl....HHHH..q",
            "N_wwwwwwwwwwl...^TTTT..q",
            "N_ww_~__~__~G,..^TTTT..q",
            "N-ww__~__~_~G,...HHHH..q",
            "N_ww~_*__~_*lv....,.....",
            "N-ww_*_~*_~_lvv.........",
            "N_ww_*_*__*_lllllllllDDl",
            "N-wwwwwwwwwwX...........",
            "N_wwwwwwwwwwX.....,.....",
            "NNNNNNww__~~llllllll....",
            "NF..oNww_~__lnn...vl....",
            "NF,.oNww___~Ghn,...d.,..",
            "NNXNNNww____l``...vl....",
            "Nwwwwwww_*__llllllll....",
            "N__*_www____lBn..vvl....",
            "N_*~_www__~_Ghn,...l....",
            "N____www____l``....d....",
            "N__*_www_~__llllllll....",
            "N~~__www____lBn....d...l",
            "N__~_www____Ghn,...l.,.l",
            "N___~www__*_l``..vvl...l",
            "NNNNNNXNNNNNllllllllllll"
            ],
	"palettes": [ "zwei_palette" ],
  "faction_owner": [ { "id": "zwei_association", "x": [ 0, 23 ], "y": [ 0, 23 ] } ],
	"place_npcs": [
        { "class": "zwei_meet_npc", "x": 17, "y": 2 },
		{ "class": "walter_npc", "x": 13, "y": 13 },
		{ "class": "isadora_npc", "x": 13, "y": 17 },
		{ "class": "julia_npc", "x": 13, "y": 21 },
		{ "class": "zwei_train_npc", "x": 10, "y": 2 },
		{ "class": "zwei_newbie_npc", "x": 2, "y": 5 }
		],
	"terrain": {
		"N": "t_brick_wall",
		"l": "t_strconc_wall_cyan",
		"O": "t_tempered_glass_with_curtain_open_window_closed",
		".": "t_linoleum_gray",
		"`": "t_linoleum_white",
		",": "t_linoleum_gray_floor_olight",
		"X": "t_door_metal_c_peep",
		"_": [ [ "t_grass", 15], [ "t_dirt",1], [ "t_grass_dead", 3] ],
		"w": "t_sidewalk",
		"d": "t_door_lab_c",
		"D": "t_door_c",
		"G": "t_reinforced_glass_shutter_open",
		"*": [ ["t_tree", 10] , ["t_tree_apple", 8], ["t_tree_peach", 5], ["t_tree_cherry", 7] ],
		"~": "t_grass"
	},
	"furniture": { 
		"n": "f_desk",
		"h": "f_chair_black",
		"H": "f_chair_white",
		"c": "f_chair",
		"S": "f_sofa",
		"T": "f_table",
		"t": "f_coffee_table",
		"B": "f_bookcase",
		"+": "f_training_dummy_heavy",
		"q": "f_counter",
		"o": "f_rack",
		"F": "f_clothing_rail",
		"b": "f_metal_butcher_rack",
		"-": "f_training_dummy_light",
		"^": "f_bulletin",
		"~": [ ["f_flower_tulip", 13], ["f_black_eyed_susan",5], [ "f_bluebell", 8] ],
		"v": "f_filing_cabinet"
},
"items": {
        "n": { "item": "SUS_office_desk", "chance": 100 },
        "v": { "item": "SUS_office_filing_cabinet", "chance": 100 },
        "R": { "item": "office_supplies", "chance": 80, "repeat": [ 1, 2 ] },
        "@": { "item": "trash", "chance": 60, "repeat": [ 1, 2 ] },
        "B": { "item": "novels", "chance": 80, "repeat": [ 4, 8 ] },
		"o": { "item": "training_weapon", "chance": 100},
		"F": { "item": "training_equipment", "chance": 100}
      }
}
},
{
"type": "mapgen",
"method": "json",
"om_terrain": [ "zwei_office2"] ,
"weight": "2000",
"object": {
	"fill_ter": "t_floor",
	 "rows": [
            "_www___lllllllllllll___N",
            "_www_~llBA...2     l___N",
            "_www_~Gt...++l h  !ll__N",
            "_www_~Gt...++lBnnl bl__N",
            "_www_~llL...qllGll ll__N",
            "_www___lllllll~~~lXl~__N",
            "wwwwwwwwwwwwwwwwwwww~__N",
            "wwwwwwwwwwwwwwwwwwww~__N",
            "wwwwwwwwwwwwwwwwwlXl~__N",
            "____llllllllllllll ll__N",
            "_*__l,l,l,l``3    !/l__N",
            "____l````````l  lctcl__N",
            "____llllllllll55lllll_*N",
            "________~Oq! 4..4 !qO~*N",
            "____*___*l+hnl..lnh+l~_N",
            "________~lllll..lllll_*N",
            "_*______~Oq! 4.k4 !qO~_N",
            "_________l+hnl..lnh+l*_N",
            "________~lllll..lllll_*N",
            "________~Oq! 4..4 !qO~_N",
            "___*____~l+hnllllnh+l~_N",
            "_________lllll**lllll*_N",
            "_______~~_______~~~____N",
            "NNNNNNNNNNNNNNNNNNNNNNNN"
            ],
	"palettes": [ "zwei_palette" ],
  "faction_owner": [ { "id": "zwei_association", "x": [ 0, 23 ], "y": [ 0, 23 ] } ],
	"place_npcs": [
        { "class": "zwei_game_npc", "x": 19, "y": 11 }
		],
	"terrain": {
		"N": "t_brick_wall",
		"l": "t_strconc_wall_cyan",
		"O": "t_tempered_glass_with_curtain_open_window_closed",
		".": "t_carpet_red",
		"`": "t_linoleum_white",
		",": "t_linoleum_gray_floor_olight",
		"X": "t_door_metal_c_peep",
		"_": [ [ "t_grass", 15], [ "t_dirt",1], [ "t_grass_dead", 3] ],
		"w": "t_sidewalk",
		"5": "t_laminated_door_glass_c",
		"3": "t_door_gray_c",
		"4": "t_door_c",
		"2": "t_door_lab_c",
		"G": "t_reinforced_glass_shutter",
		"~": "t_grass",
		"*": [ ["t_tree", 10] , ["t_tree_apple", 8], ["t_tree_peach", 5], ["t_tree_cherry", 7] ],
		"!": "t_floor_olight",
		"k": "t_carpet_red_light"
	},
	"furniture": { 
		"n": "f_desk",
		"h": "f_chair_black",
		"H": "f_chair_white",
		"c": "f_chair",
		"S": "f_sofa",
		"T": "f_table",
		"t": "f_coffee_table",
		"B": "f_bookcase",
		"+":  "f_bed",
		"q": "f_dresser",
		"o": "f_oven",
		",": "f_toilet",
		"b": "f_wardrobe",
		"~": [ ["f_flower_tulip", 13], ["f_black_eyed_susan",5], [ "f_bluebell", 8] ],
		"/": "f_rack_coat",
		"A": "f_armchair",
		"L": "f_foot_locker"
		
},
"items": {
	"q": { "item": "starter_room", "chance": 100 }
}
}
},
{
"type": "mapgen",
"method": "json",
"om_terrain": [ "zwei_office3"] ,
"weight": "2000",
"object": {
	"fill_ter": "t_floor",
	 "rows": [
            "N_____w________________|",
            "N__*__w__*_jw__________|",
            "N__**_w__**jw*__jj_____|",
            "N_____w_*_*_wwwwww_____|",
            "N__*wwww*____*_w*______|",
            "N*_wwwwww__jj__w_______|",
            "N_wwCCCCwwwwwwwwwwwwwwww",
            "N_wCC00CCwwwwwwwwwwwwwwN",
            "N_wC0000Cww____wwwwwwwww",
            "N_wCC00CCw_____wjj_____|",
            "N_wwCjjCww_____w_____*_|",
            "N_lllOOlllllll_w___*___|",
            "N_l++   ltA AO_w_*_____|",
            "N_lFF   3  !tO_w___*___|",
            "N_l++!  lBllll_w*_**___|",
            "N_lFF   lll____w_______|",
            "N_l++   ! Xwwwww___**__|",
            "N_llllll  l____**______|",
            "N_lo~~ol  llll___*_____|",
            "N_l n  l  l ql_*_______|",
            "N_Ohn! 3  3!?l_____*___|",
            "N_llllllllllll___*_____|",
            "N______________*_______|",
            "NNNNNNNNNNNNNNNNNNNNNNNN"
            ],
	"palettes": [ "zwei_palette" ],
  "faction_owner": [ { "id": "zwei_association", "x": [ 0, 23 ], "y": [ 0, 23 ] } ],
	"place_npcs": [
        { "class": "zwei_doc_npc", "x": 3, "y": 20 },
		{ "class": "zwei_sick_npc", "x": 3, "y": 16 },
		{ "class": "zwei_reader_npc", "x": 12, "y": 12 },
		{ "class": "zwei_mariya_npc", "x": 11, "y": 1 }
		],
	"terrain": {
		"N": "t_brick_wall",
		"l": "t_strconc_wall_cyan",
		"O": "t_reinforced_glass_shutter",
		".": "t_linoleum_gray",
		"`": "t_linoleum_white",
		",": "t_linoleum_gray_floor_olight",
		"X": "t_door_metal_c_peep",
		"_": [ [ "t_grass", 15], [ "t_dirt",1], [ "t_grass_dead", 3] ],
		"w": "t_sidewalk",
		"|": "t_fence",
		"!": "t_floor_olight",
		"3": "t_door_gray_c",
		"0": "t_water_pool_shallow_outdoors",
		"C": "t_concrete",
		"*": [ ["t_tree", 10] , ["t_tree_apple", 8], ["t_tree_peach", 5], ["t_tree_cherry", 7], [ "t_grass", 10] ]
	},
	"furniture": { 
		"n": "f_desk",
		"h": "f_chair_black",
		"H": "f_chair_white",
		"c": "f_chair",
		"S": "f_sofa",
		"T": "f_table",
		"t": "f_coffee_table",
		"B": "f_bookcase",
		"q": "f_sink",
		"o": "f_glass_cabinet",
		"F": "f_curtain",
		"b": "f_rack",
		"~": "f_cupboard",
		"+":  "f_bed",
		"A": "f_armchair",
		"?": "f_toilet",
		"_": [ ["f_flower_tulip", 13], ["f_black_eyed_susan",5], [ "f_bluebell", 8], [ "f_null", 60] ],
		"j": "f_bench_park"
},
"items": {
	"B": { "item": "novels", "chance": 100, "repeat": [ 8, 12 ] }
}
}
},
{
"type": "mapgen",
"method": "json",
"om_terrain": [ "zwei_office0_roof"] ,
"weight": "2000",
"object": {
	"fill_ter": "t_flat_roof",
	"rows": [
            ".                       ",
            ".                       ",
            ".                       ",
            "..................      ",
            "..................      ",
            "..................      ",
            "..................      ",
            "..................      ",
            "..................      ",
            "..................      ",
            "..................      ",
            "..................      ",
            ".....................   ",
            ".....................   ",
            ".....................   ",
            ".....................   ",
            ".....................   ",
            ".....................   ",
            ".....................   ",
            ".....................   ",
            ".....................   ",
            "                        ",
            "                        ",
            "                        "
            ],
	"palettes": [ "roof_palette" ]	
}
},
{
"type": "mapgen",
"method": "json",
"om_terrain": [ "zwei_office1_roof"] ,
"weight": "2000",
"object": {
	"fill_ter": "t_flat_roof",
	"rows": [
            "            ............",
            "            ............",
            "            ............",
            "            ............",
            "            ............",
            "            ............",
            "            ............",
            "            ............",
            "            ............",
            "            ............",
            "            ............",
            "......      ............",
            "......      ............",
            "......      ............",
            "......      ............",
            "            ............",
            "            ............",
            "            ............",
            "            ............",
            "            ............",
            "            ............",
            "            ............",
            "            ............",
            "            ............"
            ],
	"palettes": [ "roof_palette" ]	
}
},
{
"type": "mapgen",
"method": "json",
"om_terrain": [ "zwei_office2_roof"] ,
"weight": "2000",
"object": {
	"fill_ter": "t_flat_roof",
	"rows": [
            "       .............    ",
            "      ..............    ",
            "      ...............   ",
            "      ...............   ",
            "      ...............   ",
            "       .......   ...    ",
            "                        ",
            "                        ",
            "                 ...    ",
            "    .................   ",
            "    .................   ",
            "    .................   ",
            "    .................   ",
            "         ............   ",
            "         ............   ",
            "         ............   ",
            "         ............   ",
            "         ............   ",
            "         ............   ",
            "         ............   ",
            "         ............   ",
            "         .....  .....   ",
            "                        ",
            "                        "
            ],
	"palettes": [ "roof_palette" ]	
}
},
{
"type": "mapgen",
"method": "json",
"om_terrain": [ "zwei_office3_roof"] ,
"weight": "2000",
"object": {
	"fill_ter": "t_flat_roof",
	"rows": [
            "                        ",
            "                        ",
            "                        ",
            "                        ",
            "                        ",
            "                        ",
            "                        ",
            "                        ",
            "                        ",
            "                        ",
            "                        ",
            "  ............          ",
            "  ............          ",
            "  ............          ",
            "  ............          ",
            "  .........             ",
            "  .........             ",
            "  .........             ",
            "  ............          ",
            "  ............          ",
            "  ............          ",
            "  ............          ",
            "                        ",
            "                        "
            ],
	"palettes": [ "roof_palette" ]	
}
}
]