[
{
"type": "mapgen",

"om_terrain": [ "faultyzwei"] ,
"weight": 100,
"object": {
	"fill_ter": "t_grass",
	"rows": [
	"WWWWWWWWWWWWWWWWW       ",
	"WyyyyyWWyyyyyyyWW       ",
	"WyyyyyyyyyyyyyyyW       ",
	"WyyyyyWyyyyyyyyyW       ",
	"WyyyyyWWyyyyyyyyW       ",
	"WWWWWWWWWWWWWyyWW       ",
	"WyyWyyWyyWyyWyyyW       ",
	"WyyWyyWyyWyyWyyyW       ",
	"Wyyyyyyyyyyyyyyyy.......",
	"Wyyyyyyyyyyyyyyyy.......",
	"WyyWyyWyyWyyWyyyW       ",
	"WyyWyyWyyWyyWyyyW       ",
	"WWWWWWWWWWWWWWWWW       ",
	"                        ",
	"                        ",
	"                        ",
	"                        ",
	"                        ",
	"                        ",
	"                        ",
	"                        ",
	"                        ",
	"                        ",
	"                        "
	],
	"palettes": [ "zwei_palette" ],
	"place_monster": [ {"group": "PECCA_GENERAL", "x":[6,15], "y":[13,20], "pack_size": [ 1, 2 ], "repeat": [1,3] }],
	"terrain": {
		"W": "t_wall_train",
		".": "t_sidewalk",
		"y": "t_carpet_yellow"
	}
}
}
]